Region,Region Code,Province,Province Code,Municipality_City,Municipality_City Code,Housing Units,Strong Roof/Strong Wall,Strong Roof/Light Wall,Strong Roof/Salvage Wall,Light Roof/Strong Wall,Light Roof/Light Wall,Light Roof/Salvage Wall,Salvaged Roof/Strong Wall,Salvaged Roof/Light Wall,Salvaged Roof/Salvage Wall,sum_types_of_material,diff_housing_unit,percentage_,absolute_from_vulnerable_houses
Autonomous Region in Muslim Mindanao (ARMM),PH150000000,Basilan,PH150700000,Akbar,PH150708000,2560,441,1230,0,127,757,0,0,0,0,2555,5,0.2962818,757
Autonomous Region in Muslim Mindanao (ARMM),PH150000000,Basilan,PH150700000,Al-Barka,PH150709000,3647,503,1853,1,24,1253,2,0,3,0,3639,8,0.345699368,1258
Autonomous Region in Muslim Mindanao (ARMM),PH150000000,Basilan,PH150700000,City of Lamitan (Capital),PH150702000,14751,4972,6284,24,103,3244,10,6,33,23,14699,52,0.225185387,3310
Autonomous Region in Muslim Mindanao (ARMM),PH150000000,Basilan,PH150700000,Hadji Mohammad Ajul,PH150710000,2747,510,1218,7,10,991,5,0,1,1,2743,4,0.363835217,998
Autonomous Region in Muslim Mindanao (ARMM),PH150000000,Basilan,PH150700000,Hadji Muhtamad,PH150712000,3921,347,1309,5,30,2215,3,0,5,6,3920,1,0.568622449,2229
Autonomous Region in Muslim Mindanao (ARMM),PH150000000,Basilan,PH150700000,Lantawan,PH150703000,4440,667,1044,0,49,2674,3,0,0,0,4437,3,0.603335587,2677
Autonomous Region in Muslim Mindanao (ARMM),PH150000000,Basilan,PH150700000,Maluso,PH150704000,6019,741,2648,2,70,2551,1,0,1,1,6015,4,0.424605154,2554
Autonomous Region in Muslim Mindanao (ARMM),PH150000000,Basilan,PH150700000,Sumisip,PH150705000,7388,920,3463,17,27,2915,11,1,9,18,7381,7,0.40008129,2953
Autonomous Region in Muslim Mindanao (ARMM),PH150000000,Basilan,PH150700000,Tabuan-Lasa,PH150713000,3069,97,758,0,13,2201,0,0,0,0,3069,0,0.717171717,2201
Autonomous Region in Muslim Mindanao (ARMM),PH150000000,Basilan,PH150700000,Tipo-Tipo,PH150706000,3117,524,1465,0,11,1099,0,0,1,0,3100,17,0.35483871,1100
Autonomous Region in Muslim Mindanao (ARMM),PH150000000,Basilan,PH150700000,Tuburan,PH150707000,2985,630,1670,0,44,625,0,0,0,0,2969,16,0.210508589,625
Autonomous Region in Muslim Mindanao (ARMM),PH150000000,Basilan,PH150700000,Ungkaya Pukan,PH150711000,3060,639,1630,2,22,749,10,0,1,4,3057,3,0.24991822,764
Autonomous Region in Muslim Mindanao (ARMM),PH150000000,Lanao Del Sur,PH153600000,Bacolod-Kalawi (Bacolod Grande),PH153601000,2087,821,1034,1,62,158,0,0,0,0,2076,11,0.0761079,158
Autonomous Region in Muslim Mindanao (ARMM),PH150000000,Lanao Del Sur,PH153600000,Balabagan,PH153602000,4685,1923,2460,1,24,271,0,1,3,2,4685,0,0.058911419,276
Autonomous Region in Muslim Mindanao (ARMM),PH150000000,Lanao Del Sur,PH153600000,Balindong (Watu),PH153603000,3960,2161,1723,0,7,17,0,0,0,0,3908,52,0.004350051,17
Autonomous Region in Muslim Mindanao (ARMM),PH150000000,Lanao Del Sur,PH153600000,Bayang,PH153604000,2517,1138,1248,2,8,101,0,1,0,0,2498,19,0.040432346,101
Autonomous Region in Muslim Mindanao (ARMM),PH150000000,Lanao Del Sur,PH153600000,Binidayan,PH153605000,2749,1001,1361,31,2,51,0,0,0,8,2454,295,0.02404238,59
Autonomous Region in Muslim Mindanao (ARMM),PH150000000,Lanao Del Sur,PH153600000,Buadiposo-Buntong,PH153633000,1550,812,621,0,1,114,0,0,0,1,1549,1,0.074241446,115
Autonomous Region in Muslim Mindanao (ARMM),PH150000000,Lanao Del Sur,PH153600000,Bubong,PH153606000,2227,889,1331,2,0,3,0,0,0,0,2225,2,0.001348315,3
Autonomous Region in Muslim Mindanao (ARMM),PH150000000,Lanao Del Sur,PH153600000,Bumbaran,PH153637000,1776,613,1109,0,3,49,0,0,0,0,1774,2,0.027621195,49
Autonomous Region in Muslim Mindanao (ARMM),PH150000000,Lanao Del Sur,PH153600000,Butig,PH153607000,2491,931,1546,0,2,11,0,0,0,0,2490,1,0.004417671,11
Autonomous Region in Muslim Mindanao (ARMM),PH150000000,Lanao Del Sur,PH153600000,Calanogas,PH153632000,1820,184,1552,4,0,66,0,1,0,1,1808,12,0.037057522,67
Autonomous Region in Muslim Mindanao (ARMM),PH150000000,Lanao Del Sur,PH153600000,Ditsaan-Ramain,PH153624000,1976,971,914,3,3,84,0,0,1,0,1976,0,0.043016194,85
Autonomous Region in Muslim Mindanao (ARMM),PH150000000,Lanao Del Sur,PH153600000,Ganassi,PH153609000,2390,744,1414,0,11,152,0,4,48,0,2373,17,0.0842815,200
Autonomous Region in Muslim Mindanao (ARMM),PH150000000,Lanao Del Sur,PH153600000,Kapai,PH153610000,1716,361,1327,0,12,16,0,0,0,0,1716,0,0.009324009,16
Autonomous Region in Muslim Mindanao (ARMM),PH150000000,Lanao Del Sur,PH153600000,Kapatagan,PH153639000,2456,397,1867,0,2,188,0,0,0,0,2454,2,0.076609617,188
Autonomous Region in Muslim Mindanao (ARMM),PH150000000,Lanao Del Sur,PH153600000,Lumba-Bayabao (Maguing),PH153611000,3336,1332,1806,0,1,189,0,0,0,0,3328,8,0.056790865,189
Autonomous Region in Muslim Mindanao (ARMM),PH150000000,Lanao Del Sur,PH153600000,Lumbaca-Unayan,PH153641000,835,286,544,0,1,4,0,0,0,0,835,0,0.004790419,4
Autonomous Region in Muslim Mindanao (ARMM),PH150000000,Lanao Del Sur,PH153600000,Lumbatan,PH153612000,2263,871,1340,1,2,41,0,0,0,0,2255,8,0.018181818,41
Autonomous Region in Muslim Mindanao (ARMM),PH150000000,Lanao Del Sur,PH153600000,Lumbayanague,PH153636000,1782,758,969,0,5,49,0,0,0,0,1781,1,0.027512633,49
Autonomous Region in Muslim Mindanao (ARMM),PH150000000,Lanao Del Sur,PH153600000,Madalum,PH153613000,3332,745,2059,0,8,409,0,0,1,0,3222,110,0.127250155,410
Autonomous Region in Muslim Mindanao (ARMM),PH150000000,Lanao Del Sur,PH153600000,Madamba,PH153614000,2263,324,1599,0,3,321,0,0,0,0,2247,16,0.142857143,321
Autonomous Region in Muslim Mindanao (ARMM),PH150000000,Lanao Del Sur,PH153600000,Maguing,PH153634000,2954,1655,1157,2,7,80,0,0,0,15,2916,38,0.032578875,95
Autonomous Region in Muslim Mindanao (ARMM),PH150000000,Lanao Del Sur,PH153600000,Malabang,PH153615000,6172,1786,3983,8,11,346,2,1,8,10,6155,17,0.059463851,366
Autonomous Region in Muslim Mindanao (ARMM),PH150000000,Lanao Del Sur,PH153600000,Marantao,PH153616000,4083,2561,1381,0,29,96,0,3,0,0,4070,13,0.023587224,96
Autonomous Region in Muslim Mindanao (ARMM),PH150000000,Lanao Del Sur,PH153600000,City of Marawi (Capital),PH153617000,20121,11652,7596,12,33,623,24,1,4,10,19955,166,0.03312453,661
Autonomous Region in Muslim Mindanao (ARMM),PH150000000,Lanao Del Sur,PH153600000,Marogong,PH153631000,2790,387,2327,0,1,75,0,0,0,0,2790,0,0.02688172,75
Autonomous Region in Muslim Mindanao (ARMM),PH150000000,Lanao Del Sur,PH153600000,Masiu,PH153618000,3022,1409,1564,0,5,42,0,1,0,0,3021,1,0.013902681,42
Autonomous Region in Muslim Mindanao (ARMM),PH150000000,Lanao Del Sur,PH153600000,Mulondo,PH153619000,1161,646,499,0,0,3,0,0,0,0,1148,13,0.00261324,3
Autonomous Region in Muslim Mindanao (ARMM),PH150000000,Lanao Del Sur,PH153600000,Pagayawan (Tatarikan),PH153620000,1331,211,1051,1,1,53,0,0,0,0,1317,14,0.040242976,53
Autonomous Region in Muslim Mindanao (ARMM),PH150000000,Lanao Del Sur,PH153600000,Piagapo,PH153621000,3756,678,3041,0,0,31,0,0,0,0,3750,6,0.008266667,31
Autonomous Region in Muslim Mindanao (ARMM),PH150000000,Lanao Del Sur,PH153600000,Picong (Sultan Gumander),PH153635000,2342,579,1297,1,9,343,4,3,35,67,2338,4,0.192044482,449
Autonomous Region in Muslim Mindanao (ARMM),PH150000000,Lanao Del Sur,PH153600000,Poona Bayabao (Gata),PH153622000,2469,1032,1422,0,0,2,0,0,0,0,2456,13,0.000814332,2
Autonomous Region in Muslim Mindanao (ARMM),PH150000000,Lanao Del Sur,PH153600000,Pualas,PH153623000,1415,481,897,2,1,22,0,0,2,0,1405,10,0.017081851,24
Autonomous Region in Muslim Mindanao (ARMM),PH150000000,Lanao Del Sur,PH153600000,Saguiaran,PH153625000,2275,1058,1157,0,0,30,0,0,17,0,2262,13,0.020778073,47
Autonomous Region in Muslim Mindanao (ARMM),PH150000000,Lanao Del Sur,PH153600000,Sultan Dumalondong,PH153640000,1223,220,984,0,0,3,0,0,0,0,1207,16,0.002485501,3
Autonomous Region in Muslim Mindanao (ARMM),PH150000000,Lanao Del Sur,PH153600000,Tagoloan Ii,PH153638000,1283,83,1140,0,6,42,0,0,0,0,1271,12,0.033044847,42
Autonomous Region in Muslim Mindanao (ARMM),PH150000000,Lanao Del Sur,PH153600000,Tamparan,PH153626000,2022,1205,652,0,4,134,0,0,1,0,1996,26,0.067635271,135
Autonomous Region in Muslim Mindanao (ARMM),PH150000000,Lanao Del Sur,PH153600000,Taraka,PH153627000,1987,1455,526,0,0,5,0,0,0,0,1986,1,0.002517623,5
Autonomous Region in Muslim Mindanao (ARMM),PH150000000,Lanao Del Sur,PH153600000,Tubaran,PH153628000,1685,466,866,0,1,348,0,1,0,0,1682,3,0.206896552,348
Autonomous Region in Muslim Mindanao (ARMM),PH150000000,Lanao Del Sur,PH153600000,Tugaya,PH153629000,2170,1139,1028,0,0,3,0,0,0,0,2170,0,0.001382488,3
Autonomous Region in Muslim Mindanao (ARMM),PH150000000,Lanao Del Sur,PH153600000,Wao,PH153630000,8900,2801,5944,4,1,101,0,0,0,0,8851,49,0.01141114,101
Autonomous Region in Muslim Mindanao (ARMM),PH150000000,Maguindanao,PH153800000,Ampatuan,PH153801000,3910,1544,771,0,100,1486,0,0,2,0,3903,7,0.381245196,1488
Autonomous Region in Muslim Mindanao (ARMM),PH150000000,Maguindanao,PH153800000,Barira,PH153818000,4485,922,3113,0,8,436,0,0,1,0,4480,5,0.097544643,437
Autonomous Region in Muslim Mindanao (ARMM),PH150000000,Maguindanao,PH153800000,Buldon,PH153802000,5540,884,3881,2,25,726,2,0,5,1,5526,14,0.132826638,734
Autonomous Region in Muslim Mindanao (ARMM),PH150000000,Maguindanao,PH153800000,Buluan,PH153803000,7281,3062,1403,2,388,2387,0,0,0,0,7242,39,0.329605081,2387
Autonomous Region in Muslim Mindanao (ARMM),PH150000000,Maguindanao,PH153800000,Datu Abdullah Sangki,PH153828000,3768,1009,995,1,106,1568,0,1,0,0,3680,88,0.426086957,1568
Autonomous Region in Muslim Mindanao (ARMM),PH150000000,Maguindanao,PH153800000,Datu Anggal Midtimbang,PH153831000,3796,1447,1427,0,18,878,0,0,1,0,3771,25,0.23309467,879
Autonomous Region in Muslim Mindanao (ARMM),PH150000000,Maguindanao,PH153800000,Datu Blah T. Sinsuat,PH153830000,3839,326,863,0,16,2294,258,0,3,25,3785,54,0.681638045,2580
Autonomous Region in Muslim Mindanao (ARMM),PH150000000,Maguindanao,PH153800000,Datu Hoffer Ampatuan,PH153835000,4308,856,571,0,166,2708,0,0,0,0,4301,7,0.629621018,2708
Autonomous Region in Muslim Mindanao (ARMM),PH150000000,Maguindanao,PH153800000,Datu Odin Sinsuat (Dinaig),PH153807000,16943,6111,5471,36,273,4695,40,7,80,155,16868,75,0.29464074,4970
Autonomous Region in Muslim Mindanao (ARMM),PH150000000,Maguindanao,PH153800000,Datu Paglas,PH153805000,4642,1503,994,4,88,1996,4,0,0,0,4589,53,0.435824798,2000
Autonomous Region in Muslim Mindanao (ARMM),PH150000000,Maguindanao,PH153800000,Datu Piang,PH153806000,4167,1039,2237,0,27,805,1,1,8,0,4118,49,0.197668771,814
Autonomous Region in Muslim Mindanao (ARMM),PH150000000,Maguindanao,PH153800000,Datu Salibo,PH153836000,2597,316,1093,0,1,1067,7,0,9,12,2505,92,0.437125749,1095
Autonomous Region in Muslim Mindanao (ARMM),PH150000000,Maguindanao,PH153800000,Datu Saudi-Ampatuan,PH153826000,4354,1015,2071,0,25,1205,0,1,2,0,4319,35,0.279462839,1207
Autonomous Region in Muslim Mindanao (ARMM),PH150000000,Maguindanao,PH153800000,Datu Unsay,PH153827000,1769,378,298,0,35,1056,1,0,0,1,1769,0,0.59807801,1058
Autonomous Region in Muslim Mindanao (ARMM),PH150000000,Maguindanao,PH153800000,Gen. S.K. Pendatun,PH153819000,4167,1039,765,3,94,2211,43,0,9,1,4165,2,0.543577431,2264
Autonomous Region in Muslim Mindanao (ARMM),PH150000000,Maguindanao,PH153800000,Guindulungan,PH153825000,2992,1105,403,0,30,1453,0,0,1,0,2992,0,0.485962567,1454
Autonomous Region in Muslim Mindanao (ARMM),PH150000000,Maguindanao,PH153800000,Kabuntalan (Tumbao),PH153814000,2401,343,1578,0,24,420,6,1,25,2,2399,2,0.188828679,453
Autonomous Region in Muslim Mindanao (ARMM),PH150000000,Maguindanao,PH153800000,Mamasapano,PH153820000,3915,1116,1514,0,54,1214,1,2,4,8,3913,2,0.313570151,1227
Autonomous Region in Muslim Mindanao (ARMM),PH150000000,Maguindanao,PH153800000,Mangudadatu,PH153832000,3836,622,766,0,66,2376,0,0,0,0,3830,6,0.620365535,2376
Autonomous Region in Muslim Mindanao (ARMM),PH150000000,Maguindanao,PH153800000,Matanog,PH153809000,4524,902,2984,16,11,438,0,13,2,146,4512,12,0.129875887,586
Autonomous Region in Muslim Mindanao (ARMM),PH150000000,Maguindanao,PH153800000,Northern Kabuntalan,PH153834000,3069,946,1520,1,15,567,6,2,3,4,3064,5,0.189295039,580
Autonomous Region in Muslim Mindanao (ARMM),PH150000000,Maguindanao,PH153800000,Pagagawan,PH153822000,5608,1000,1328,3,75,3175,4,0,1,21,5607,1,0.570893526,3201
Autonomous Region in Muslim Mindanao (ARMM),PH150000000,Maguindanao,PH153800000,Pagalungan,PH153810000,6738,1594,1144,121,423,2911,90,6,77,356,6722,16,0.510859863,3434
Autonomous Region in Muslim Mindanao (ARMM),PH150000000,Maguindanao,PH153800000,Paglat,PH153823000,2455,666,375,6,69,1300,13,0,1,5,2435,20,0.541683778,1319
Autonomous Region in Muslim Mindanao (ARMM),PH150000000,Maguindanao,PH153800000,Pandag,PH153833000,3906,1174,513,1,95,2118,0,1,0,0,3902,4,0.542798565,2118
Autonomous Region in Muslim Mindanao (ARMM),PH150000000,Maguindanao,PH153800000,Parang,PH153811000,15262,6790,6633,22,103,1572,8,1,13,2,15144,118,0.10532224,1595
Autonomous Region in Muslim Mindanao (ARMM),PH150000000,Maguindanao,PH153800000,Rajah Buayan,PH153829000,3768,1370,619,0,164,1607,0,0,0,0,3760,8,0.427393617,1607
Autonomous Region in Muslim Mindanao (ARMM),PH150000000,Maguindanao,PH153800000,Shariff Aguak (Maganoy) (Capital),PH153808000,4812,1808,1477,0,243,1219,12,0,2,1,4762,50,0.259134817,1234
Autonomous Region in Muslim Mindanao (ARMM),PH150000000,Maguindanao,PH153800000,Shariff Saydona Mustapha,PH153837000,3568,426,767,0,51,2313,0,0,1,2,3560,8,0.650561798,2316
Autonomous Region in Muslim Mindanao (ARMM),PH150000000,Maguindanao,PH153800000,South Upi,PH153817000,7418,608,2241,1,40,4475,22,0,4,1,7392,26,0.609036797,4502
Autonomous Region in Muslim Mindanao (ARMM),PH150000000,Maguindanao,PH153800000,Sultan Kudarat (Nuling),PH153812000,15331,4067,6828,11,109,4129,40,8,12,38,15242,89,0.276800945,4219
Autonomous Region in Muslim Mindanao (ARMM),PH150000000,Maguindanao,PH153800000,Sultan Mastura,PH153824000,3832,2136,956,10,58,665,1,0,0,0,3826,6,0.174072138,666
Autonomous Region in Muslim Mindanao (ARMM),PH150000000,Maguindanao,PH153800000,Sultan Sa Barongis (Lambayong),PH153813000,3515,865,179,1,295,2162,3,1,0,0,3506,9,0.617512835,2165
Autonomous Region in Muslim Mindanao (ARMM),PH150000000,Maguindanao,PH153800000,Talayan,PH153816000,4244,1252,1467,0,117,1405,0,0,2,0,4243,1,0.331604996,1407
Autonomous Region in Muslim Mindanao (ARMM),PH150000000,Maguindanao,PH153800000,Talitay,PH153821000,2390,381,1063,2,23,915,0,0,2,0,2386,4,0.384325231,917
Autonomous Region in Muslim Mindanao (ARMM),PH150000000,Maguindanao,PH153800000,Upi,PH153815000,10879,2108,5197,13,30,3248,5,0,9,4,10614,265,0.307706802,3266
Autonomous Region in Muslim Mindanao (ARMM),PH150000000,Sulu,PH156600000,Hadji Panglima Tahil (Marunggas),PH156606000,1091,7,454,2,9,606,11,0,1,0,1090,1,0.566972477,618
Autonomous Region in Muslim Mindanao (ARMM),PH150000000,Sulu,PH156600000,Indanan,PH156601000,13848,1880,4998,2,101,6756,0,2,17,16,13772,76,0.492956724,6789
Autonomous Region in Muslim Mindanao (ARMM),PH150000000,Sulu,PH156600000,Jolo (Capital),PH156602000,18644,5373,9391,9,83,3368,2,23,136,13,18398,246,0.19127079,3519
Autonomous Region in Muslim Mindanao (ARMM),PH150000000,Sulu,PH156600000,Kalingalan Caluang,PH156603000,5535,143,4008,0,36,1331,0,0,0,0,5518,17,0.241210584,1331
Autonomous Region in Muslim Mindanao (ARMM),PH150000000,Sulu,PH156600000,Lugus,PH156617000,3831,86,1443,0,10,2287,0,0,1,0,3827,4,0.59785733,2288
Autonomous Region in Muslim Mindanao (ARMM),PH150000000,Sulu,PH156600000,Luuk,PH156604000,5279,453,2408,1,104,2298,3,0,5,2,5274,5,0.437618506,2308
Autonomous Region in Muslim Mindanao (ARMM),PH150000000,Sulu,PH156600000,Maimbung,PH156605000,6346,173,2599,1,26,3431,0,0,2,0,6232,114,0.550866496,3433
Autonomous Region in Muslim Mindanao (ARMM),PH150000000,Sulu,PH156600000,Old Panamao,PH156607000,6234,410,2787,0,30,2863,0,1,38,7,6136,98,0.473924381,2908
Autonomous Region in Muslim Mindanao (ARMM),PH150000000,Sulu,PH156600000,Omar,PH156619000,4367,135,2251,0,8,1961,0,0,2,0,4357,10,0.450539362,1963
Autonomous Region in Muslim Mindanao (ARMM),PH150000000,Sulu,PH156600000,Pandami,PH156618000,4870,269,1731,0,54,2807,4,0,0,0,4865,5,0.577800617,2811
Autonomous Region in Muslim Mindanao (ARMM),PH150000000,Sulu,PH156600000,Panglima Estino (New Panamao),PH156616000,4064,293,1732,0,28,1949,1,0,0,0,4003,61,0.487134649,1950
Autonomous Region in Muslim Mindanao (ARMM),PH150000000,Sulu,PH156600000,Pangutaran,PH156608000,5235,440,2557,0,23,2208,1,0,1,0,5230,5,0.422562141,2210
Autonomous Region in Muslim Mindanao (ARMM),PH150000000,Sulu,PH156600000,Parang,PH156609000,9613,1084,4348,0,45,4051,0,0,4,0,9532,81,0.425409148,4055
Autonomous Region in Muslim Mindanao (ARMM),PH150000000,Sulu,PH156600000,Pata,PH156610000,3580,187,1025,0,46,2316,0,0,1,0,3575,5,0.648111888,2317
Autonomous Region in Muslim Mindanao (ARMM),PH150000000,Sulu,PH156600000,Patikul,PH156611000,10854,2459,5449,0,44,2792,1,2,4,2,10753,101,0.260299451,2799
Autonomous Region in Muslim Mindanao (ARMM),PH150000000,Sulu,PH156600000,Siasi,PH156612000,12195,861,3754,0,106,7321,7,0,1,0,12050,145,0.608215768,7329
Autonomous Region in Muslim Mindanao (ARMM),PH150000000,Sulu,PH156600000,Talipao,PH156613000,12190,486,7557,1,60,3842,2,0,4,0,11952,238,0.321954485,3848
Autonomous Region in Muslim Mindanao (ARMM),PH150000000,Sulu,PH156600000,Tapul,PH156614000,3123,69,478,0,13,2485,19,0,1,2,3067,56,0.817411151,2507
Autonomous Region in Muslim Mindanao (ARMM),PH150000000,Sulu,PH156600000,Tongkil,PH156615000,4184,150,1779,0,49,2206,0,0,0,0,4184,0,0.527246654,2206
Autonomous Region in Muslim Mindanao (ARMM),PH150000000,Tawi-Tawi,PH157000000,Bongao (Capital),PH157002000,16539,3451,10798,16,31,2187,5,2,20,8,16518,21,0.134398838,2220
Autonomous Region in Muslim Mindanao (ARMM),PH150000000,Tawi-Tawi,PH157000000,Languyan,PH157009000,5051,114,2525,1,12,2301,31,0,2,2,4988,63,0.468323978,2336
Autonomous Region in Muslim Mindanao (ARMM),PH150000000,Tawi-Tawi,PH157000000,Mapun (Cagayan De Tawi-Tawi),PH157003000,4008,548,2042,2,50,1285,6,1,1,2,3937,71,0.328676657,1294
Autonomous Region in Muslim Mindanao (ARMM),PH150000000,Tawi-Tawi,PH157000000,Panglima Sugala (Balimbing),PH157001000,6433,279,4172,0,20,1918,0,0,0,0,6389,44,0.300203475,1918
Autonomous Region in Muslim Mindanao (ARMM),PH150000000,Tawi-Tawi,PH157000000,Sapa-Sapa,PH157010000,4770,232,3189,0,5,1338,1,0,0,0,4765,5,0.281007345,1339
Autonomous Region in Muslim Mindanao (ARMM),PH150000000,Tawi-Tawi,PH157000000,Sibutu,PH157011000,3910,694,2941,0,10,241,0,0,0,0,3886,24,0.062017499,241
Autonomous Region in Muslim Mindanao (ARMM),PH150000000,Tawi-Tawi,PH157000000,Simunul,PH157004000,3205,935,1682,1,16,555,1,0,1,0,3191,14,0.174553432,557
Autonomous Region in Muslim Mindanao (ARMM),PH150000000,Tawi-Tawi,PH157000000,Sitangkai,PH157005000,5331,230,4117,1,10,967,3,0,1,1,5330,1,0.182363977,972
Autonomous Region in Muslim Mindanao (ARMM),PH150000000,Tawi-Tawi,PH157000000,South Ubian,PH157006000,3707,144,2846,0,4,708,0,0,0,0,3702,5,0.191247974,708
Autonomous Region in Muslim Mindanao (ARMM),PH150000000,Tawi-Tawi,PH157000000,Tandubas,PH157007000,3902,246,3026,0,5,621,0,1,0,0,3899,3,0.159271608,621
Autonomous Region in Muslim Mindanao (ARMM),PH150000000,Tawi-Tawi,PH157000000,Turtle Islands,PH157008000,782,56,65,0,7,650,0,0,2,2,782,0,0.836317136,654
Cordillera Administrative Region (CAR),PH140000000,Abra,PH140100000,Bangued (Capital),PH140101000,10787,9253,1269,11,12,201,2,0,1,2,10751,36,0.019161008,206
Cordillera Administrative Region (CAR),PH140000000,Abra,PH140100000,Boliney,PH140102000,758,391,349,1,1,7,0,0,0,0,749,9,0.009345794,7
Cordillera Administrative Region (CAR),PH140000000,Abra,PH140100000,Bucay,PH140103000,3813,2952,720,4,3,97,1,0,1,0,3778,35,0.026204341,99
Cordillera Administrative Region (CAR),PH140000000,Abra,PH140100000,Bucloc,PH140104000,435,257,163,0,1,5,0,0,0,0,426,9,0.011737089,5
Cordillera Administrative Region (CAR),PH140000000,Abra,PH140100000,Daguioman,PH140105000,375,241,129,0,0,4,0,0,0,0,374,1,0.010695187,4
Cordillera Administrative Region (CAR),PH140000000,Abra,PH140100000,Danglas,PH140106000,873,630,206,0,1,31,0,0,0,0,868,5,0.035714286,31
Cordillera Administrative Region (CAR),PH140000000,Abra,PH140100000,Dolores,PH140107000,2484,1756,639,0,1,74,0,0,0,0,2470,14,0.029959514,74
Cordillera Administrative Region (CAR),PH140000000,Abra,PH140100000,La Paz,PH140108000,3325,2322,862,26,4,66,0,0,1,2,3283,42,0.021017362,69
Cordillera Administrative Region (CAR),PH140000000,Abra,PH140100000,Lacub,PH140109000,647,276,354,1,0,11,0,0,0,0,642,5,0.017133956,11
Cordillera Administrative Region (CAR),PH140000000,Abra,PH140100000,Lagangilang,PH140110000,3048,2193,759,1,3,66,0,0,0,0,3022,26,0.021839841,66
Cordillera Administrative Region (CAR),PH140000000,Abra,PH140100000,Lagayan,PH140111000,932,459,396,0,0,64,0,0,0,0,919,13,0.069640914,64
Cordillera Administrative Region (CAR),PH140000000,Abra,PH140100000,Langiden,PH140112000,660,485,83,0,9,59,0,0,0,0,636,24,0.092767296,59
Cordillera Administrative Region (CAR),PH140000000,Abra,PH140100000,Licuan-Baay (Licuan),PH140113000,943,486,440,0,0,10,0,0,0,0,936,7,0.010683761,10
Cordillera Administrative Region (CAR),PH140000000,Abra,PH140100000,Luba,PH140114000,1358,953,382,0,0,13,0,0,0,1,1349,9,0.010378058,14
Cordillera Administrative Region (CAR),PH140000000,Abra,PH140100000,Malibcong,PH140115000,743,257,474,0,0,9,0,0,0,0,740,3,0.012162162,9
Cordillera Administrative Region (CAR),PH140000000,Abra,PH140100000,Manabo,PH140116000,2410,1936,414,3,1,20,1,1,0,0,2376,34,0.008838384,21
Cordillera Administrative Region (CAR),PH140000000,Abra,PH140100000,Peñarrubia,PH140117000,1463,1064,291,0,1,91,0,0,0,0,1447,16,0.062888735,91
Cordillera Administrative Region (CAR),PH140000000,Abra,PH140100000,Pidigan,PH140118000,2600,2108,456,1,4,18,0,0,0,0,2587,13,0.006957866,18
Cordillera Administrative Region (CAR),PH140000000,Abra,PH140100000,Pilar,PH140119000,2262,1366,851,0,4,27,0,0,0,0,2248,14,0.012010676,27
Cordillera Administrative Region (CAR),PH140000000,Abra,PH140100000,Sallapadan,PH140120000,1341,854,389,0,26,68,0,0,0,0,1337,4,0.050860135,68
Cordillera Administrative Region (CAR),PH140000000,Abra,PH140100000,San Isidro,PH140121000,1054,625,399,1,2,21,0,0,0,0,1048,6,0.020038168,21
Cordillera Administrative Region (CAR),PH140000000,Abra,PH140100000,San Juan,PH140122000,2157,1474,543,0,2,133,0,0,0,0,2152,5,0.061802974,133
Cordillera Administrative Region (CAR),PH140000000,Abra,PH140100000,San Quintin,PH140123000,1239,1055,138,0,3,38,0,0,0,0,1234,5,0.030794165,38
Cordillera Administrative Region (CAR),PH140000000,Abra,PH140100000,Tayum,PH140124000,3016,2249,570,3,8,167,0,0,1,0,2998,18,0.056037358,168
Cordillera Administrative Region (CAR),PH140000000,Abra,PH140100000,Tineg,PH140125000,830,58,675,0,1,88,1,0,1,1,825,5,0.11030303,91
Cordillera Administrative Region (CAR),PH140000000,Abra,PH140100000,Tubo,PH140126000,982,786,193,0,0,2,0,0,0,0,981,1,0.002038736,2
Cordillera Administrative Region (CAR),PH140000000,Abra,PH140100000,Villaviciosa,PH140127000,1058,701,313,0,1,33,0,0,0,0,1048,10,0.03148855,33
Cordillera Administrative Region (CAR),PH140000000,Apayao,PH148100000,Calanasan (Bayag),PH148101000,2382,885,1305,0,10,174,1,1,2,0,2378,4,0.074432296,177
Cordillera Administrative Region (CAR),PH140000000,Apayao,PH148100000,Conner,PH148102000,5466,2722,2294,4,7,427,0,0,0,3,5457,9,0.078797874,430
Cordillera Administrative Region (CAR),PH140000000,Apayao,PH148100000,Flora,PH148103000,4042,2103,1600,3,10,308,2,0,1,1,4028,14,0.077457795,312
Cordillera Administrative Region (CAR),PH140000000,Apayao,PH148100000,Kabugao (Capital),PH148104000,3130,1258,1536,5,9,312,1,0,0,0,3121,9,0.100288369,313
Cordillera Administrative Region (CAR),PH140000000,Apayao,PH148100000,Luna,PH148105000,4129,2695,727,1,92,593,1,1,1,3,4114,15,0.145357316,598
Cordillera Administrative Region (CAR),PH140000000,Apayao,PH148100000,Pudtol,PH148106000,3158,1821,874,12,13,419,9,1,1,5,3155,3,0.137559429,434
Cordillera Administrative Region (CAR),PH140000000,Apayao,PH148100000,Santa Marcela,PH148107000,3111,2156,638,2,23,280,1,0,0,3,3103,8,0.091524331,284
Cordillera Administrative Region (CAR),PH140000000,Benguet,PH141100000,Atok,PH141101000,4332,4077,230,3,2,17,0,0,0,0,4329,3,0.003927004,17
Cordillera Administrative Region (CAR),PH140000000,Benguet,PH141100000,City of Baguio,PH141102000,87731,83249,4230,51,6,27,2,8,11,58,87642,89,0.001118185,98
Cordillera Administrative Region (CAR),PH140000000,Benguet,PH141100000,Bakun,PH141103000,3347,2951,359,7,0,25,1,0,0,1,3344,3,0.008074163,27
Cordillera Administrative Region (CAR),PH140000000,Benguet,PH141100000,Bokod,PH141104000,2873,2500,363,0,1,9,0,0,0,0,2873,0,0.003132614,9
Cordillera Administrative Region (CAR),PH140000000,Benguet,PH141100000,Buguias,PH141105000,10863,10210,525,4,3,36,0,0,1,2,10781,82,0.003617475,39
Cordillera Administrative Region (CAR),PH140000000,Benguet,PH141100000,Itogon,PH141106000,14204,13056,795,41,8,207,5,1,8,64,14185,19,0.020021149,284
Cordillera Administrative Region (CAR),PH140000000,Benguet,PH141100000,Kabayan,PH141107000,3483,2604,686,8,5,95,4,0,6,9,3417,66,0.033362599,114
Cordillera Administrative Region (CAR),PH140000000,Benguet,PH141100000,Kapangan,PH141108000,4194,3733,328,15,6,35,0,0,0,0,4117,77,0.008501336,35
Cordillera Administrative Region (CAR),PH140000000,Benguet,PH141100000,Kibungan,PH141109000,3584,3138,227,16,6,108,0,0,0,1,3496,88,0.03117849,109
Cordillera Administrative Region (CAR),PH140000000,Benguet,PH141100000,La Trinidad (Capital),PH141110000,33599,32872,631,14,10,23,1,2,0,4,33557,42,0.000834401,28
Cordillera Administrative Region (CAR),PH140000000,Benguet,PH141100000,Mankayan,PH141111000,8062,6800,878,14,8,26,1,0,0,1,7728,334,0.003623188,28
Cordillera Administrative Region (CAR),PH140000000,Benguet,PH141100000,Sablan,PH141112000,2599,2382,148,5,0,5,0,0,1,1,2542,57,0.002753737,7
Cordillera Administrative Region (CAR),PH140000000,Benguet,PH141100000,Tuba,PH141113000,11123,10048,878,32,2,40,1,1,2,8,11012,111,0.004631311,51
Cordillera Administrative Region (CAR),PH140000000,Benguet,PH141100000,Tublay,PH141114000,3854,3645,180,2,1,22,0,0,0,2,3852,2,0.00623053,24
Cordillera Administrative Region (CAR),PH140000000,Ifugao,PH142700000,Aguinaldo,PH142708000,4658,1744,2627,0,5,279,0,0,1,0,4656,2,0.060137457,280
Cordillera Administrative Region (CAR),PH140000000,Ifugao,PH142700000,Alfonso Lista (Potia),PH142707000,7138,4870,1616,1,29,606,0,0,0,2,7124,14,0.085345312,608
Cordillera Administrative Region (CAR),PH140000000,Ifugao,PH142700000,Asipulo,PH142711000,2829,790,1832,0,1,194,0,0,0,0,2817,12,0.06886759,194
Cordillera Administrative Region (CAR),PH140000000,Ifugao,PH142700000,Banaue,PH142701000,3925,2472,1217,1,1,203,0,0,0,0,3894,31,0.052131484,203
Cordillera Administrative Region (CAR),PH140000000,Ifugao,PH142700000,Hingyon,PH142709000,2044,1190,815,4,2,9,0,0,0,0,2020,24,0.004455446,9
Cordillera Administrative Region (CAR),PH140000000,Ifugao,PH142700000,Hungduan,PH142702000,1939,711,1216,2,0,7,1,0,0,1,1938,1,0.004643963,9
Cordillera Administrative Region (CAR),PH140000000,Ifugao,PH142700000,Kiangan,PH142703000,3479,1782,1672,3,1,9,0,0,0,0,3467,12,0.002595904,9
Cordillera Administrative Region (CAR),PH140000000,Ifugao,PH142700000,Lagawe (Capital),PH142704000,3944,2398,1417,1,0,115,0,0,0,0,3931,13,0.029254643,115
Cordillera Administrative Region (CAR),PH140000000,Ifugao,PH142700000,Lamut,PH142705000,5593,3947,1434,2,7,173,1,1,1,7,5573,20,0.032657456,182
Cordillera Administrative Region (CAR),PH140000000,Ifugao,PH142700000,Mayoyao,PH142706000,4071,1927,1892,0,4,245,0,0,0,0,4068,3,0.060226155,245
Cordillera Administrative Region (CAR),PH140000000,Ifugao,PH142700000,Tinoc,PH142710000,3597,1899,1502,7,0,154,10,1,1,4,3578,19,0.047233091,169
Cordillera Administrative Region (CAR),PH140000000,Kalinga,PH143200000,Balbalan,PH143201000,2301,656,1556,0,2,86,0,0,1,0,2301,0,0.037809648,87
Cordillera Administrative Region (CAR),PH140000000,Kalinga,PH143200000,City of Tabuk (Capital),PH143213000,22350,17757,3583,93,80,730,11,2,4,14,22274,76,0.034075604,759
Cordillera Administrative Region (CAR),PH140000000,Kalinga,PH143200000,Lubuagan,PH143206000,1728,730,983,0,1,10,0,0,0,0,1724,4,0.005800464,10
Cordillera Administrative Region (CAR),PH140000000,Kalinga,PH143200000,Pasil,PH143208000,1797,795,977,1,0,24,0,0,0,0,1797,0,0.013355593,24
Cordillera Administrative Region (CAR),PH140000000,Kalinga,PH143200000,Pinukpuk,PH143209000,6258,2333,2869,6,11,1015,10,0,2,1,6247,11,0.164558988,1028
Cordillera Administrative Region (CAR),PH140000000,Kalinga,PH143200000,Rizal (Liwan),PH143211000,3718,2479,778,10,65,369,7,0,0,1,3709,9,0.101644648,377
Cordillera Administrative Region (CAR),PH140000000,Kalinga,PH143200000,Tanudan,PH143214000,1568,179,1353,0,0,36,0,0,0,0,1568,0,0.022959184,36
Cordillera Administrative Region (CAR),PH140000000,Kalinga,PH143200000,Tinglayan,PH143215000,2270,1037,1160,7,0,62,1,0,0,1,2268,2,0.028218695,64
Cordillera Administrative Region (CAR),PH140000000,Mountain Province,PH144400000,Barlig,PH144401000,1190,851,335,0,0,4,0,0,0,0,1190,0,0.003361345,4
Cordillera Administrative Region (CAR),PH140000000,Mountain Province,PH144400000,Bauko,PH144402000,6790,5778,718,5,2,28,3,0,0,1,6535,255,0.00489671,32
Cordillera Administrative Region (CAR),PH140000000,Mountain Province,PH144400000,Besao,PH144403000,1710,1235,462,1,1,5,0,0,0,0,1704,6,0.002934272,5
Cordillera Administrative Region (CAR),PH140000000,Mountain Province,PH144400000,Bontoc (Capital),PH144404000,6307,5757,511,2,0,0,0,0,0,2,6272,35,0.000318878,2
Cordillera Administrative Region (CAR),PH140000000,Mountain Province,PH144400000,Natonin,PH144405000,2187,1373,748,2,2,45,0,0,0,0,2170,17,0.020737327,45
Cordillera Administrative Region (CAR),PH140000000,Mountain Province,PH144400000,Paracelis,PH144406000,5826,2452,2850,11,10,477,3,0,7,1,5811,15,0.083978661,488
Cordillera Administrative Region (CAR),PH140000000,Mountain Province,PH144400000,Sabangan,PH144407000,2215,1665,529,1,1,2,0,0,1,0,2199,16,0.001364256,3
Cordillera Administrative Region (CAR),PH140000000,Mountain Province,PH144400000,Sadanga,PH144408000,1764,1330,433,1,0,0,0,0,0,0,1764,0,0,0
Cordillera Administrative Region (CAR),PH140000000,Mountain Province,PH144400000,Sagada,PH144409000,2641,1717,901,2,0,1,0,0,0,0,2621,20,0.000381534,1
Cordillera Administrative Region (CAR),PH140000000,Mountain Province,PH144400000,Tadian,PH144410000,4227,3420,627,5,0,18,0,0,0,1,4071,156,0.004667158,19
National Capital Region (NCR),PH130000000,"NCR, Fourth District (Not a Province)",PH137600000,City of Las Piñas,PH137601000,137897,120456,15766,66,113,861,14,35,109,287,137707,190,0.009229741,1271
National Capital Region (NCR),PH130000000,"NCR, Fourth District (Not a Province)",PH137600000,City of Makati,PH137602000,148430,138830,9050,16,16,193,15,13,38,93,148264,166,0.002286462,339
National Capital Region (NCR),PH130000000,"NCR, Fourth District (Not a Province)",PH137600000,City of Muntinlupa,PH137603000,115515,97791,15622,67,178,1161,38,51,140,199,115247,268,0.01334525,1538
National Capital Region (NCR),PH130000000,"NCR, Fourth District (Not a Province)",PH137600000,City of Parañaque,PH137604000,159587,136392,21676,105,95,395,12,34,186,352,159247,340,0.005934178,945
National Capital Region (NCR),PH130000000,"NCR, Fourth District (Not a Province)",PH137600000,Pasay City,PH137605000,101557,86968,14079,98,3,204,11,7,11,77,101458,99,0.002986457,303
National Capital Region (NCR),PH130000000,"NCR, Fourth District (Not a Province)",PH137600000,Pateros,PH137606000,13393,11522,1687,13,4,64,0,6,75,16,13387,6,0.011578397,155
National Capital Region (NCR),PH130000000,"NCR, Fourth District (Not a Province)",PH137600000,City of Taguig,PH137607000,192862,168730,21837,294,68,980,12,22,236,271,192450,412,0.007789036,1499
National Capital Region (NCR),PH130000000,"NCR, Second District (Not a Province)",PH137400000,City of Mandaluyong,PH137401000,93319,80952,11307,8,23,47,5,36,95,105,92578,741,0.002722029,252
National Capital Region (NCR),PH130000000,"NCR, Second District (Not a Province)",PH137400000,City of Marikina,PH137402000,95305,89333,5566,29,17,54,0,40,51,137,95227,78,0.002541296,242
National Capital Region (NCR),PH130000000,"NCR, Second District (Not a Province)",PH137400000,City of Pasig,PH137403000,175280,158041,16091,46,60,526,5,19,158,124,175070,210,0.004643857,813
National Capital Region (NCR),PH130000000,"NCR, Second District (Not a Province)",PH137400000,City of San Juan,PH137405000,26768,23306,2729,0,0,2,0,0,1,19,26057,711,0.000844303,22
National Capital Region (NCR),PH130000000,"NCR, Second District (Not a Province)",PH137400000,Quezon City,PH137404000,660249,594966,59311,565,146,991,105,352,473,1302,658211,2038,0.004361823,2871
National Capital Region (NCR),PH130000000,"NCR, Third District (Not a Province)",PH137500000,City of Caloocan,PH137501000,353357,327470,23339,270,108,613,37,222,208,647,352914,443,0.004264495,1505
National Capital Region (NCR),PH130000000,"NCR, Third District (Not a Province)",PH137500000,City of Malabon,PH137502000,81724,64932,15421,123,58,615,12,56,163,237,81617,107,0.012583163,1027
National Capital Region (NCR),PH130000000,"NCR, Third District (Not a Province)",PH137500000,City of Navotas,PH137503000,56260,42611,12792,32,11,574,18,10,39,99,56186,74,0.01299256,730
National Capital Region (NCR),PH130000000,"NCR, Third District (Not a Province)",PH137500000,City of Valenzuela,PH137504000,147161,134599,11917,84,34,197,6,20,61,116,147034,127,0.002584436,380
Region VI (Western Visayas),PH060000000,Negros Occidental,PH064500000,City of Bacolod (Capital),PH064501000,126516,91096,27099,877,317,5266,108,58,189,493,125503,1013,0.048253827,6056
Region VI (Western Visayas),PH060000000,Negros Occidental,PH064500000,City of Bago,PH064502000,39765,18619,14999,154,220,5381,47,7,30,116,39573,192,0.140853612,5574
Region VI (Western Visayas),PH060000000,Negros Occidental,PH064500000,Binalbagan,PH064503000,14823,7175,4883,18,158,2512,6,1,5,12,14770,53,0.171631686,2535
Region VI (Western Visayas),PH060000000,Negros Occidental,PH064500000,City of Cadiz,PH064504000,34947,15553,11279,162,455,7165,66,8,36,48,34772,175,0.210370413,7315
Region VI (Western Visayas),PH060000000,Negros Occidental,PH064500000,Calatrava,PH064505000,18380,4916,9679,163,58,3434,25,0,18,19,18312,68,0.190913062,3496
Region VI (Western Visayas),PH060000000,Negros Occidental,PH064500000,Candoni,PH064506000,4947,1448,2705,7,15,753,0,0,0,0,4928,19,0.152800325,753
Region VI (Western Visayas),PH060000000,Negros Occidental,PH064500000,Cauayan,PH064507000,22604,5399,5187,57,833,10924,74,11,27,60,22572,32,0.491095162,11085
Region VI (Western Visayas),PH060000000,Negros Occidental,PH064500000,City of Escalante,PH064509000,21519,9723,8504,72,88,2904,13,5,38,92,21439,80,0.142124166,3047
Region VI (Western Visayas),PH060000000,Negros Occidental,PH064500000,City of Himamaylan,PH064510000,25229,10163,8271,37,235,6156,26,3,20,36,24947,282,0.250050106,6238
Region VI (Western Visayas),PH060000000,Negros Occidental,PH064500000,City of Kabankalan,PH064515000,39841,12234,19660,169,197,6786,30,51,184,31,39342,499,0.178714859,7031
Region VI (Western Visayas),PH060000000,Negros Occidental,PH064500000,City of Sipalay,PH064527000,14783,5349,4234,19,295,4781,12,1,2,26,14719,64,0.327535838,4821
Region VI (Western Visayas),PH060000000,Negros Occidental,PH064500000,City of Talisay,PH064528000,22840,14290,6616,34,56,1577,7,3,15,19,22617,223,0.071539108,1618
Region VI (Western Visayas),PH060000000,Negros Occidental,PH064500000,City of Victorias,PH064531000,19063,11708,5112,189,101,1671,52,6,23,58,18920,143,0.095348837,1804
Region VI (Western Visayas),PH060000000,Negros Occidental,PH064500000,Enrique B. Magalona (Saravia),PH064508000,14180,8394,3572,35,118,1891,14,7,14,22,14067,113,0.137982512,1941
Region VI (Western Visayas),PH060000000,Negros Occidental,PH064500000,Hinigaran,PH064511000,20421,10167,4094,44,292,5427,40,1,28,176,20269,152,0.279786867,5671
Region VI (Western Visayas),PH060000000,Negros Occidental,PH064500000,Hinoba-An (Asia),PH064512000,12368,4711,2543,12,397,4654,10,2,2,3,12334,34,0.378547106,4669
Region VI (Western Visayas),PH060000000,Negros Occidental,PH064500000,Ilog,PH064513000,12698,4150,4082,7,266,4122,12,2,3,15,12659,39,0.327987993,4152
Region VI (Western Visayas),PH060000000,Negros Occidental,PH064500000,Isabela,PH064514000,13332,5188,5793,24,84,2121,19,1,3,1,13234,98,0.162006952,2144
Region VI (Western Visayas),PH060000000,Negros Occidental,PH064500000,City of La Carlota,PH064516000,15375,9153,3865,21,105,2103,6,0,7,33,15293,82,0.140521807,2149
Region VI (Western Visayas),PH060000000,Negros Occidental,PH064500000,La Castellana,PH064517000,16740,6990,7446,59,63,1995,20,16,16,62,16667,73,0.125577488,2093
Region VI (Western Visayas),PH060000000,Negros Occidental,PH064500000,Manapla,PH064518000,12254,6983,3258,16,135,1761,6,3,8,5,12175,79,0.146201232,1780
Region VI (Western Visayas),PH060000000,Negros Occidental,PH064500000,Moises Padilla (Magallon),PH064519000,8841,2909,4683,4,17,1140,8,0,23,16,8800,41,0.134886364,1187
Region VI (Western Visayas),PH060000000,Negros Occidental,PH064500000,Murcia,PH064520000,18227,9131,6693,73,94,2118,3,2,14,11,18139,88,0.118308617,2146
Region VI (Western Visayas),PH060000000,Negros Occidental,PH064500000,Pontevedra,PH064521000,12008,6121,3152,18,107,2339,11,1,9,12,11770,238,0.20144435,2371
Region VI (Western Visayas),PH060000000,Negros Occidental,PH064500000,Pulupandan,PH064522000,6267,4041,1118,10,145,916,12,1,5,2,6250,17,0.1496,935
Region VI (Western Visayas),PH060000000,Negros Occidental,PH064500000,City of Sagay,PH064523000,33246,13791,12588,149,191,6177,37,6,35,114,33088,158,0.192305368,6363
Region VI (Western Visayas),PH060000000,Negros Occidental,PH064500000,Salvador Benedicto,PH064532000,5862,1440,3875,8,6,475,0,0,2,0,5806,56,0.08215639,477
Region VI (Western Visayas),PH060000000,Negros Occidental,PH064500000,City of San Carlos,PH064524000,30569,11089,14366,96,55,4506,14,3,28,54,30211,358,0.152328622,4602
Region VI (Western Visayas),PH060000000,Negros Occidental,PH064500000,San Enrique,PH064525000,5557,3161,1219,10,65,1023,7,0,3,61,5549,8,0.19715264,1094
Region VI (Western Visayas),PH060000000,Negros Occidental,PH064500000,City of Silay,PH064526000,28348,18815,6848,204,156,1841,23,15,54,72,28028,320,0.071000428,1990
Region VI (Western Visayas),PH060000000,Negros Occidental,PH064500000,Toboso,PH064529000,9724,3214,5072,40,28,1321,0,1,3,13,9692,32,0.137948824,1337
Region VI (Western Visayas),PH060000000,Negros Occidental,PH064500000,Valladolid,PH064530000,8836,5436,1779,38,85,1429,12,0,4,22,8805,31,0.166609881,1467
Region VII (Central Visayas),PH070000000,Negros Oriental,PH074600000,Amlan (Ayuquitan),PH074601000,5524,2289,890,1,379,1950,1,0,1,3,5514,10,0.354552049,1955
Region VII (Central Visayas),PH070000000,Negros Oriental,PH074600000,Ayungon,PH074602000,10412,2579,3315,13,250,4217,13,0,1,5,10393,19,0.407582026,4236
Region VII (Central Visayas),PH070000000,Negros Oriental,PH074600000,Bacong,PH074603000,8255,5043,1168,6,239,1757,4,0,3,2,8222,33,0.214789589,1766
Region VII (Central Visayas),PH070000000,Negros Oriental,PH074600000,City of Bais,PH074604000,17577,6661,6889,56,225,3469,30,2,14,13,17359,218,0.2031223,3526
Region VII (Central Visayas),PH070000000,Negros Oriental,PH074600000,Basay,PH074605000,5914,1859,1491,2,257,2242,8,2,6,3,5870,44,0.38483816,2259
Region VII (Central Visayas),PH070000000,Negros Oriental,PH074600000,Bindoy (Payabon),PH074607000,8673,1923,2868,12,144,3618,8,2,13,79,8667,6,0.428983501,3718
Region VII (Central Visayas),PH070000000,Negros Oriental,PH074600000,City of Canlaon,PH074608000,12624,5462,6165,99,22,762,7,0,10,17,12544,80,0.063456633,796
Region VII (Central Visayas),PH070000000,Negros Oriental,PH074600000,City of Bayawan (Tulong),PH074606000,25532,7508,11388,51,206,6103,37,3,20,55,25371,161,0.244964724,6215
Region VII (Central Visayas),PH070000000,Negros Oriental,PH074600000,City of Guihulngan,PH074611000,22324,5673,9711,47,225,6486,41,2,43,36,22264,60,0.296712181,6606
Region VII (Central Visayas),PH070000000,Negros Oriental,PH074600000,City of Tanjay,PH074621000,18281,8838,4544,7,517,4211,24,12,7,51,18211,70,0.235736643,4293
Region VII (Central Visayas),PH070000000,Negros Oriental,PH074600000,Dauin,PH074609000,6500,3245,756,1,223,2243,2,3,3,6,6482,18,0.347732181,2254
Region VII (Central Visayas),PH070000000,Negros Oriental,PH074600000,City of Dumaguete (Capital),PH074610000,29262,21859,3890,42,564,2561,37,20,22,99,29094,168,0.093455695,2719
Region VII (Central Visayas),PH070000000,Negros Oriental,PH074600000,Jimalalud,PH074612000,7100,1605,1360,4,119,3864,10,2,81,9,7054,46,0.561950666,3964
Region VII (Central Visayas),PH070000000,Negros Oriental,PH074600000,La Libertad,PH074613000,9138,1934,3271,18,143,3628,21,0,5,10,9030,108,0.405758583,3664
Region VII (Central Visayas),PH070000000,Negros Oriental,PH074600000,Mabinay,PH074614000,17645,4922,10371,231,43,1889,31,4,44,50,17585,60,0.114529428,2014
Region VII (Central Visayas),PH070000000,Negros Oriental,PH074600000,Manjuyod,PH074615000,9923,3855,2917,9,173,2848,6,0,25,4,9837,86,0.293077158,2883
Region VII (Central Visayas),PH070000000,Negros Oriental,PH074600000,Pamplona,PH074616000,8701,3372,2997,167,87,1810,56,5,29,165,8688,13,0.237108656,2060
Region VII (Central Visayas),PH070000000,Negros Oriental,PH074600000,San Jose,PH074617000,4583,2262,783,3,154,1366,2,1,1,4,4576,7,0.300043706,1373
Region VII (Central Visayas),PH070000000,Negros Oriental,PH074600000,Santa Catalina,PH074618000,16712,4533,5572,42,398,5849,52,0,20,40,16506,206,0.361141403,5961
Region VII (Central Visayas),PH070000000,Negros Oriental,PH074600000,Siaton,PH074619000,17820,5724,3925,14,462,7511,14,1,4,15,17670,150,0.426938314,7544
Region VII (Central Visayas),PH070000000,Negros Oriental,PH074600000,Sibulan,PH074620000,13886,7619,2050,25,576,3464,35,0,11,10,13790,96,0.255257433,3520
Region VII (Central Visayas),PH070000000,Negros Oriental,PH074600000,Tayasan,PH074622000,8447,1607,2802,7,82,3880,11,0,1,1,8391,56,0.46394947,3893
Region VII (Central Visayas),PH070000000,Negros Oriental,PH074600000,Valencia (Luzurriaga),PH074623000,7965,4783,1710,28,126,1206,9,1,15,9,7887,78,0.157093952,1239
Region VII (Central Visayas),PH070000000,Negros Oriental,PH074600000,Vallehermoso,PH074624000,8496,2819,3306,6,79,2136,10,2,4,29,8391,105,0.259682994,2179
Region VII (Central Visayas),PH070000000,Negros Oriental,PH074600000,Zamboanguita,PH074625000,6600,2789,941,1,169,2636,6,0,5,14,6561,39,0.405578418,2661
Region I (Ilocos Region),PH010000000,Ilocos Norte,PH012800000,Adams,PH012801000,411,250,150,0,1,10,0,0,0,0,411,0,0.0243309,10
Region I (Ilocos Region),PH010000000,Ilocos Norte,PH012800000,Bacarra,PH012802000,7717,7064,588,7,5,35,0,1,0,2,7702,15,0.004803947,37
Region I (Ilocos Region),PH010000000,Ilocos Norte,PH012800000,Badoc,PH012803000,7155,5780,735,3,111,468,2,0,0,3,7102,53,0.066600957,473
Region I (Ilocos Region),PH010000000,Ilocos Norte,PH012800000,Bangui,PH012804000,3534,3153,236,6,39,92,6,0,0,0,3532,2,0.027746319,98
Region I (Ilocos Region),PH010000000,Ilocos Norte,PH012800000,Banna (Espiritu),PH012811000,4421,3672,504,1,18,218,3,0,1,0,4417,4,0.050260358,222
Region I (Ilocos Region),PH010000000,Ilocos Norte,PH012800000,Burgos,PH012806000,2352,1875,230,8,46,185,6,0,0,1,2351,1,0.081667376,192
Region I (Ilocos Region),PH010000000,Ilocos Norte,PH012800000,Carasi,PH012807000,304,273,26,0,0,5,0,0,0,0,304,0,0.016447368,5
Region I (Ilocos Region),PH010000000,Ilocos Norte,PH012800000,City of Batac,PH012805000,12348,10691,1355,9,40,232,2,1,0,0,12330,18,0.018978102,234
Region I (Ilocos Region),PH010000000,Ilocos Norte,PH012800000,Currimao,PH012808000,2658,2302,225,5,21,80,5,0,0,1,2639,19,0.032588102,86
Region I (Ilocos Region),PH010000000,Ilocos Norte,PH012800000,Dingras,PH012809000,8394,7424,710,30,36,154,11,0,2,11,8378,16,0.021246121,178
Region I (Ilocos Region),PH010000000,Ilocos Norte,PH012800000,Dumalneg,PH012810000,555,472,64,0,2,17,0,0,0,0,555,0,0.030630631,17
Region I (Ilocos Region),PH010000000,Ilocos Norte,PH012800000,City of Laoag (Capital),PH012812000,23229,21610,1393,11,36,143,1,1,2,11,23208,21,0.006764909,157
Region I (Ilocos Region),PH010000000,Ilocos Norte,PH012800000,Marcos,PH012813000,3919,3411,341,3,26,119,2,1,0,6,3909,10,0.032489128,127
Region I (Ilocos Region),PH010000000,Ilocos Norte,PH012800000,Nueva Era,PH012814000,2038,1477,249,5,11,271,1,0,3,4,2021,17,0.13805047,279
Region I (Ilocos Region),PH010000000,Ilocos Norte,PH012800000,Pagudpud,PH012815000,5427,3870,482,2,452,620,1,0,0,0,5427,0,0.114427861,621
Region I (Ilocos Region),PH010000000,Ilocos Norte,PH012800000,Paoay,PH012816000,5436,4756,240,2,61,373,1,0,1,0,5434,2,0.069009937,375
Region I (Ilocos Region),PH010000000,Ilocos Norte,PH012800000,Pasuquin,PH012817000,6441,5442,570,16,85,313,6,0,1,2,6435,6,0.05003885,322
Region I (Ilocos Region),PH010000000,Ilocos Norte,PH012800000,Piddig,PH012818000,4866,4215,489,2,19,136,0,0,1,1,4863,3,0.028377545,138
Region I (Ilocos Region),PH010000000,Ilocos Norte,PH012800000,Pinili,PH012819000,3812,3089,507,2,22,180,0,0,0,0,3800,12,0.047368421,180
Region I (Ilocos Region),PH010000000,Ilocos Norte,PH012800000,San Nicolas,PH012820000,7846,7295,450,9,7,69,1,0,0,0,7831,15,0.008938833,70
Region I (Ilocos Region),PH010000000,Ilocos Norte,PH012800000,Sarrat,PH012821000,5594,5140,387,0,11,42,0,0,0,0,5580,14,0.007526882,42
Region I (Ilocos Region),PH010000000,Ilocos Norte,PH012800000,Solsona,PH012822000,5270,4746,383,7,10,99,0,0,0,1,5246,24,0.019062143,100
Region I (Ilocos Region),PH010000000,Ilocos Norte,PH012800000,Vintar,PH012823000,7686,7034,552,8,11,64,0,0,0,0,7669,17,0.008345286,64
Region I (Ilocos Region),PH010000000,Ilocos Sur,PH012900000,Alilem,PH012901000,1475,1226,222,1,0,14,0,0,0,0,1463,12,0.009569378,14
Region I (Ilocos Region),PH010000000,Ilocos Sur,PH012900000,Banayoyo,PH012902000,1780,1420,321,0,0,25,1,0,2,0,1769,11,0.015828151,28
Region I (Ilocos Region),PH010000000,Ilocos Sur,PH012900000,Bantay,PH012903000,7712,7158,465,14,5,51,0,0,1,5,7699,13,0.007403559,57
Region I (Ilocos Region),PH010000000,Ilocos Sur,PH012900000,Burgos,PH012904000,2740,2005,671,5,0,41,0,0,1,1,2724,16,0.015785609,43
Region I (Ilocos Region),PH010000000,Ilocos Sur,PH012900000,Cabugao,PH012905000,7894,6471,1059,6,32,254,2,0,3,4,7831,63,0.033584472,263
Region I (Ilocos Region),PH010000000,Ilocos Sur,PH012900000,Caoayan,PH012907000,4318,3764,457,2,13,76,0,0,0,0,4312,6,0.017625232,76
Region I (Ilocos Region),PH010000000,Ilocos Sur,PH012900000,Cervantes,PH012908000,3671,2873,535,5,17,113,2,0,0,0,3545,126,0.032440056,115
Region I (Ilocos Region),PH010000000,Ilocos Sur,PH012900000,City of Candon,PH012906000,13414,11116,2076,14,3,147,0,1,4,5,13366,48,0.011671405,156
Region I (Ilocos Region),PH010000000,Ilocos Sur,PH012900000,City of Vigan (Capital),PH012934000,11106,10170,705,28,28,138,1,1,1,7,11079,27,0.013268346,147
Region I (Ilocos Region),PH010000000,Ilocos Sur,PH012900000,Galimuyod,PH012909000,2313,1763,510,2,0,23,2,0,0,0,2300,13,0.010869565,25
Region I (Ilocos Region),PH010000000,Ilocos Sur,PH012900000,Gregorio Del Pilar (Concepcion),PH012910000,905,695,206,1,1,2,0,0,0,0,905,0,0.002209945,2
Region I (Ilocos Region),PH010000000,Ilocos Sur,PH012900000,Lidlidda,PH012911000,996,785,199,1,1,6,0,0,0,1,993,3,0.007049345,7
Region I (Ilocos Region),PH010000000,Ilocos Sur,PH012900000,Magsingal,PH012912000,7166,5633,834,10,62,544,4,21,28,18,7154,12,0.083030472,594
Region I (Ilocos Region),PH010000000,Ilocos Sur,PH012900000,Nagbukel,PH012913000,1182,909,254,0,2,17,0,0,0,0,1182,0,0.014382403,17
Region I (Ilocos Region),PH010000000,Ilocos Sur,PH012900000,Narvacan,PH012914000,9605,8163,1103,15,18,262,1,1,5,2,9570,35,0.028213166,270
Region I (Ilocos Region),PH010000000,Ilocos Sur,PH012900000,Quirino (Angkaki),PH012915000,1824,1460,301,0,2,17,0,0,1,0,1781,43,0.010106682,18
Region I (Ilocos Region),PH010000000,Ilocos Sur,PH012900000,Salcedo (Baugen),PH012916000,2650,2011,603,0,0,31,1,0,0,0,2646,4,0.012093726,32
Region I (Ilocos Region),PH010000000,Ilocos Sur,PH012900000,San Emilio,PH012917000,1530,1013,503,1,1,9,0,0,0,0,1527,3,0.00589391,9
Region I (Ilocos Region),PH010000000,Ilocos Sur,PH012900000,San Esteban,PH012918000,1884,1537,324,1,0,17,1,0,0,1,1881,3,0.01010101,19
Region I (Ilocos Region),PH010000000,Ilocos Sur,PH012900000,San Ildefonso,PH012919000,1697,1577,77,0,6,35,0,0,0,0,1695,2,0.020648968,35
Region I (Ilocos Region),PH010000000,Ilocos Sur,PH012900000,San Juan (Lapog),PH012920000,6151,5088,860,11,15,157,2,1,2,0,6136,15,0.026238592,161
Region I (Ilocos Region),PH010000000,Ilocos Sur,PH012900000,San Vicente,PH012921000,2761,2542,138,12,11,44,3,0,1,6,2757,4,0.019586507,54
Region I (Ilocos Region),PH010000000,Ilocos Sur,PH012900000,Santa,PH012922000,3412,3191,153,5,5,35,2,0,0,4,3395,17,0.012076583,41
Region I (Ilocos Region),PH010000000,Ilocos Sur,PH012900000,Santa Catalina,PH012923000,2765,2647,70,3,16,28,0,0,1,0,2765,0,0.010488246,29
Region I (Ilocos Region),PH010000000,Ilocos Sur,PH012900000,Santa Cruz,PH012924000,8851,6714,1714,5,19,351,1,0,0,0,8804,47,0.039981826,352
Region I (Ilocos Region),PH010000000,Ilocos Sur,PH012900000,Santa Lucia,PH012925000,5795,4709,510,4,63,491,0,1,1,3,5782,13,0.085610515,495
Region I (Ilocos Region),PH010000000,Ilocos Sur,PH012900000,Santa Maria,PH012926000,6648,5700,779,7,7,144,0,0,0,0,6637,11,0.02169655,144
Region I (Ilocos Region),PH010000000,Ilocos Sur,PH012900000,Santiago,PH012927000,4295,3547,544,43,2,115,2,0,1,25,4279,16,0.033419023,143
Region I (Ilocos Region),PH010000000,Ilocos Sur,PH012900000,Santo Domingo,PH012928000,6475,5816,394,9,19,229,1,1,0,0,6469,6,0.035554181,230
Region I (Ilocos Region),PH010000000,Ilocos Sur,PH012900000,Sigay,PH012929000,513,264,247,0,0,1,0,0,0,0,512,1,0.001953125,1
Region I (Ilocos Region),PH010000000,Ilocos Sur,PH012900000,Sinait,PH012930000,5872,4744,736,3,46,319,5,0,2,3,5858,14,0.056162513,329
Region I (Ilocos Region),PH010000000,Ilocos Sur,PH012900000,Sugpon,PH012931000,849,535,220,1,4,84,0,0,0,0,844,5,0.099526066,84
Region I (Ilocos Region),PH010000000,Ilocos Sur,PH012900000,Suyo,PH012932000,2497,1765,588,0,4,86,0,0,0,0,2443,54,0.03520262,86
Region I (Ilocos Region),PH010000000,Ilocos Sur,PH012900000,Tagudin,PH012933000,8492,6753,1387,7,19,175,3,0,2,4,8350,142,0.022035928,184
Region I (Ilocos Region),PH010000000,La Union,PH013300000,Agoo,PH013301000,13404,11329,1798,30,22,154,1,0,2,6,13342,62,0.012217059,163
Region I (Ilocos Region),PH010000000,La Union,PH013300000,Aringay,PH013302000,10621,7849,2477,40,13,152,3,2,8,31,10575,46,0.018345154,194
Region I (Ilocos Region),PH010000000,La Union,PH013300000,Bacnotan,PH013303000,9692,7965,1498,22,10,173,0,0,0,0,9668,24,0.017894084,173
Region I (Ilocos Region),PH010000000,La Union,PH013300000,Bagulin,PH013304000,2966,2375,549,0,1,10,0,0,0,0,2935,31,0.003407155,10
Region I (Ilocos Region),PH010000000,La Union,PH013300000,Balaoan,PH013305000,8697,7044,1413,31,9,114,2,0,0,4,8617,80,0.01392596,120
Region I (Ilocos Region),PH010000000,La Union,PH013300000,Bangar,PH013306000,7628,6093,1278,38,8,147,1,0,1,3,7569,59,0.020081913,152
Region I (Ilocos Region),PH010000000,La Union,PH013300000,Bauang,PH013307000,16577,13213,2722,154,37,243,10,4,14,18,16415,162,0.017362169,285
Region I (Ilocos Region),PH010000000,La Union,PH013300000,Burgos,PH013308000,1747,1433,285,0,1,23,0,0,0,0,1742,5,0.013203215,23
Region I (Ilocos Region),PH010000000,La Union,PH013300000,Caba,PH013309000,5070,3659,1249,42,1,59,2,0,0,0,5012,58,0.01217079,61
Region I (Ilocos Region),PH010000000,La Union,PH013300000,City of San Fernando (Capital),PH013314000,27912,23780,3802,69,4,92,0,1,5,31,27784,128,0.004606968,128
Region I (Ilocos Region),PH010000000,La Union,PH013300000,Luna,PH013310000,8189,6851,1074,10,16,196,1,0,3,2,8153,36,0.024776156,202
Region I (Ilocos Region),PH010000000,La Union,PH013300000,Naguilian,PH013311000,11874,9415,2075,27,18,211,2,0,1,1,11750,124,0.018297872,215
Region I (Ilocos Region),PH010000000,La Union,PH013300000,Pugo,PH013312000,4347,3687,518,11,5,80,0,0,1,0,4302,45,0.018828452,81
Region I (Ilocos Region),PH010000000,La Union,PH013300000,Rosario,PH013313000,12009,9934,1734,47,17,146,1,3,6,11,11899,110,0.013782671,164
Region I (Ilocos Region),PH010000000,La Union,PH013300000,San Gabriel,PH013315000,3877,2794,980,19,2,47,0,0,2,7,3851,26,0.014541677,56
Region I (Ilocos Region),PH010000000,La Union,PH013300000,San Juan,PH013316000,8462,6746,1458,16,16,158,0,0,3,11,8408,54,0.020456708,172
Region I (Ilocos Region),PH010000000,La Union,PH013300000,Santo Tomas,PH013317000,8114,6194,1601,96,12,139,7,2,7,28,8086,28,0.022384368,181
Region I (Ilocos Region),PH010000000,La Union,PH013300000,Santol,PH013318000,2780,1884,819,2,0,56,0,0,0,0,2761,19,0.020282506,56
Region I (Ilocos Region),PH010000000,La Union,PH013300000,Sudipen,PH013319000,3758,2890,720,0,6,120,0,0,2,1,3739,19,0.032896496,123
Region I (Ilocos Region),PH010000000,La Union,PH013300000,Tubao,PH013320000,6372,5051,1013,27,10,162,0,1,7,5,6276,96,0.027724665,174
Region I (Ilocos Region),PH010000000,Pangasinan,PH015500000,Agno,PH015501000,6593,3927,1514,13,44,1028,5,0,1,5,6537,56,0.15894141,1039
Region I (Ilocos Region),PH010000000,Pangasinan,PH015500000,Aguilar,PH015502000,8591,6459,1390,24,58,610,2,1,0,11,8555,36,0.072822911,623
Region I (Ilocos Region),PH010000000,Pangasinan,PH015500000,Alcala,PH015504000,10057,7712,1697,36,23,446,6,0,8,5,9933,124,0.046813651,465
Region I (Ilocos Region),PH010000000,Pangasinan,PH015500000,Anda,PH015505000,9321,5412,3269,35,16,489,16,0,9,19,9265,56,0.057528332,533
Region I (Ilocos Region),PH010000000,Pangasinan,PH015500000,Asingan,PH015506000,13064,10782,1624,15,58,502,2,0,2,8,12993,71,0.039559763,514
Region I (Ilocos Region),PH010000000,Pangasinan,PH015500000,Balungao,PH015507000,6891,5251,1225,11,18,342,2,0,3,4,6856,35,0.051196033,351
Region I (Ilocos Region),PH010000000,Pangasinan,PH015500000,Bani,PH015508000,12225,7938,2815,47,51,1280,13,5,6,27,12182,43,0.108849122,1326
Region I (Ilocos Region),PH010000000,Pangasinan,PH015500000,Basista,PH015509000,6885,5353,1097,10,57,295,1,0,0,9,6822,63,0.044708297,305
Region I (Ilocos Region),PH010000000,Pangasinan,PH015500000,Bautista,PH015510000,6860,5191,1373,10,26,166,5,3,11,3,6788,72,0.027253978,185
Region I (Ilocos Region),PH010000000,Pangasinan,PH015500000,Bayambang,PH015511000,25004,18295,5030,95,135,1167,9,20,12,33,24796,208,0.049241813,1221
Region I (Ilocos Region),PH010000000,Pangasinan,PH015500000,Binalonan,PH015512000,12655,10612,1426,55,32,425,6,1,2,23,12582,73,0.036242251,456
Region I (Ilocos Region),PH010000000,Pangasinan,PH015500000,Binmaley,PH015513000,18204,12864,3251,128,209,1603,31,8,9,41,18144,60,0.092813051,1684
Region I (Ilocos Region),PH010000000,Pangasinan,PH015500000,Bolinao,PH015514000,17601,11391,4325,259,70,1156,51,8,24,89,17373,228,0.075979969,1320
Region I (Ilocos Region),PH010000000,Pangasinan,PH015500000,Bugallon,PH015515000,14276,10124,1744,95,181,1962,77,2,3,33,14221,55,0.145910977,2075
Region I (Ilocos Region),PH010000000,Pangasinan,PH015500000,Burgos,PH015516000,4768,3082,941,4,14,697,2,0,0,9,4749,19,0.149084018,708
Region I (Ilocos Region),PH010000000,Pangasinan,PH015500000,Calasiao,PH015517000,21504,17361,2877,120,117,725,17,2,12,48,21279,225,0.037689741,802
Region I (Ilocos Region),PH010000000,Pangasinan,PH015500000,City of Alaminos,PH015503000,21410,15644,3860,57,171,1503,18,11,14,40,21318,92,0.073881227,1575
Region I (Ilocos Region),PH010000000,Pangasinan,PH015500000,City of Urdaneta,PH015546000,29630,24137,4102,73,101,958,10,2,9,18,29410,220,0.03383203,995
Region I (Ilocos Region),PH010000000,Pangasinan,PH015500000,City of Dagupan,PH015518000,35748,26325,7359,186,100,1398,20,11,18,72,35489,259,0.04249204,1508
Region I (Ilocos Region),PH010000000,Pangasinan,PH015500000,Dasol,PH015519000,6677,4100,1145,15,55,1243,10,1,3,28,6600,77,0.194545455,1284
Region I (Ilocos Region),PH010000000,Pangasinan,PH015500000,Infanta,PH015520000,5584,3410,866,14,96,1054,8,1,4,4,5457,127,0.196078431,1070
Region I (Ilocos Region),PH010000000,Pangasinan,PH015500000,Labrador,PH015521000,5473,4055,836,15,37,429,3,2,3,28,5408,65,0.085613905,463
Region I (Ilocos Region),PH010000000,Pangasinan,PH015500000,Laoac,PH015548000,7154,5976,834,9,27,239,1,0,6,15,7107,47,0.036724356,261
Region I (Ilocos Region),PH010000000,Pangasinan,PH015500000,Lingayen (Capital),PH015522000,21235,14825,2749,69,286,2979,58,48,27,65,21106,129,0.148251682,3129
Region I (Ilocos Region),PH010000000,Pangasinan,PH015500000,Mabini,PH015523000,5856,3477,1352,42,27,880,6,6,34,9,5833,23,0.159266244,929
Region I (Ilocos Region),PH010000000,Pangasinan,PH015500000,Malasiqui,PH015524000,28609,21371,5552,57,101,1210,7,11,14,68,28391,218,0.045753936,1299
Region I (Ilocos Region),PH010000000,Pangasinan,PH015500000,Manaoag,PH015525000,14633,11412,2375,47,36,521,2,2,4,24,14423,210,0.03820287,551
Region I (Ilocos Region),PH010000000,Pangasinan,PH015500000,Mangaldan,PH015526000,22611,18448,2523,64,143,1278,6,2,4,32,22500,111,0.058666667,1320
Region I (Ilocos Region),PH010000000,Pangasinan,PH015500000,Mangatarem,PH015527000,16231,11510,2942,32,86,1335,10,14,12,15,15956,275,0.085986463,1372
Region I (Ilocos Region),PH010000000,Pangasinan,PH015500000,Mapandan,PH015528000,7596,6737,646,12,25,140,3,0,2,4,7569,27,0.01968556,149
Region I (Ilocos Region),PH010000000,Pangasinan,PH015500000,Natividad,PH015529000,5690,4538,649,2,60,367,0,2,0,0,5618,72,0.065325739,367
Region I (Ilocos Region),PH010000000,Pangasinan,PH015500000,Pozorrubio,PH015530000,15789,13233,1716,106,51,514,7,1,10,26,15664,125,0.035559244,557
Region I (Ilocos Region),PH010000000,Pangasinan,PH015500000,Rosales,PH015531000,14365,11912,1934,23,38,349,0,1,2,3,14262,103,0.024821203,354
Region I (Ilocos Region),PH010000000,Pangasinan,PH015500000,City of San Carlos,PH015532000,40867,31382,4993,190,288,3373,48,18,51,190,40533,334,0.090346138,3662
Region I (Ilocos Region),PH010000000,Pangasinan,PH015500000,San Fabian,PH015533000,18991,13929,3561,161,120,905,39,7,11,39,18772,219,0.052951204,994
Region I (Ilocos Region),PH010000000,Pangasinan,PH015500000,San Jacinto,PH015534000,8983,7057,1281,10,100,404,4,2,1,7,8866,117,0.046920821,416
Region I (Ilocos Region),PH010000000,Pangasinan,PH015500000,San Manuel,PH015535000,11622,9508,1235,51,41,709,4,5,8,25,11586,36,0.064388055,746
Region I (Ilocos Region),PH010000000,Pangasinan,PH015500000,San Nicolas,PH015536000,8133,6335,1133,5,34,585,0,2,0,5,8099,34,0.0728485,590
Region I (Ilocos Region),PH010000000,Pangasinan,PH015500000,San Quintin,PH015537000,8002,6283,918,14,74,639,1,2,2,1,7934,68,0.08104361,643
Region I (Ilocos Region),PH010000000,Pangasinan,PH015500000,Santa Barbara,PH015538000,18206,14819,2408,111,92,592,10,2,5,10,18049,157,0.034184719,617
Region I (Ilocos Region),PH010000000,Pangasinan,PH015500000,Santa Maria,PH015539000,7371,6370,753,24,20,147,1,0,2,5,7322,49,0.021169079,155
Region I (Ilocos Region),PH010000000,Pangasinan,PH015500000,Santo Tomas,PH015540000,3338,2869,305,9,12,46,2,0,2,4,3249,89,0.016620499,54
Region I (Ilocos Region),PH010000000,Pangasinan,PH015500000,Sison,PH015541000,10532,9058,988,32,56,333,3,2,6,14,10492,40,0.033930614,356
Region I (Ilocos Region),PH010000000,Pangasinan,PH015500000,Sual,PH015542000,7817,4908,1741,30,69,973,11,0,5,7,7744,73,0.128615702,996
Region I (Ilocos Region),PH010000000,Pangasinan,PH015500000,Tayug,PH015543000,9837,7947,1373,34,24,361,4,1,6,21,9771,66,0.040118719,392
Region I (Ilocos Region),PH010000000,Pangasinan,PH015500000,Umingan,PH015544000,16983,12461,1892,13,227,2270,7,1,7,12,16890,93,0.135938425,2296
Region I (Ilocos Region),PH010000000,Pangasinan,PH015500000,Urbiztondo,PH015545000,10418,7245,2049,23,70,903,3,1,6,10,10310,108,0.08942774,922
Region I (Ilocos Region),PH010000000,Pangasinan,PH015500000,Villasis,PH015547000,14350,11542,1931,30,55,675,4,0,5,14,14256,94,0.048961841,698
Region II (Cagayan Valley),PH020000000,Batanes,PH020900000,Basco (Capital),PH020901000,2309,2266,10,0,2,2,0,0,0,0,2280,29,0.000877193,2
Region II (Cagayan Valley),PH020000000,Batanes,PH020900000,Itbayat,PH020902000,828,512,165,0,40,110,0,0,0,0,827,1,0.133010883,110
Region II (Cagayan Valley),PH020000000,Batanes,PH020900000,Ivana,PH020903000,357,328,0,0,27,2,0,0,0,0,357,0,0.005602241,2
Region II (Cagayan Valley),PH020000000,Batanes,PH020900000,Mahatao,PH020904000,443,410,3,0,6,20,0,0,0,0,439,4,0.045558087,20
Region II (Cagayan Valley),PH020000000,Batanes,PH020900000,Sabtang,PH020905000,418,256,0,0,135,13,0,0,0,0,404,14,0.032178218,13
Region II (Cagayan Valley),PH020000000,Batanes,PH020900000,Uyugan,PH020906000,354,328,0,0,25,1,0,0,0,0,354,0,0.002824859,1
Region II (Cagayan Valley),PH020000000,Cagayan,PH021500000,Abulug,PH021501000,7375,5356,694,0,211,1106,1,1,0,2,7371,4,0.150454484,1109
Region II (Cagayan Valley),PH020000000,Cagayan,PH021500000,Alcala,PH021502000,9163,6555,2329,7,14,226,1,1,4,1,9138,25,0.025388488,232
Region II (Cagayan Valley),PH020000000,Cagayan,PH021500000,Allacapan,PH021503000,7535,4156,2719,5,15,618,4,0,3,8,7528,7,0.084086079,633
Region II (Cagayan Valley),PH020000000,Cagayan,PH021500000,Amulung,PH021504000,10616,6516,3441,13,24,555,4,0,0,3,10556,60,0.053239864,562
Region II (Cagayan Valley),PH020000000,Cagayan,PH021500000,Aparri,PH021505000,13825,10017,2071,44,213,1445,14,2,8,6,13820,5,0.10658466,1473
Region II (Cagayan Valley),PH020000000,Cagayan,PH021500000,Baggao,PH021506000,19282,11990,6492,39,15,646,1,1,5,4,19193,89,0.034179128,656
Region II (Cagayan Valley),PH020000000,Cagayan,PH021500000,Ballesteros,PH021507000,7973,5389,1052,1,165,1354,0,1,0,0,7962,11,0.170057774,1354
Region II (Cagayan Valley),PH020000000,Cagayan,PH021500000,Buguey,PH021508000,6689,4489,934,1,216,1042,1,0,2,0,6685,4,0.15632012,1045
Region II (Cagayan Valley),PH020000000,Cagayan,PH021500000,Calayan,PH021509000,3883,1373,769,0,161,1580,0,0,0,0,3883,0,0.40690188,1580
Region II (Cagayan Valley),PH020000000,Cagayan,PH021500000,Camalaniugan,PH021510000,5383,3823,1350,3,17,184,3,0,0,2,5382,1,0.035117057,189
Region II (Cagayan Valley),PH020000000,Cagayan,PH021500000,Claveria,PH021511000,6956,5162,421,0,630,735,2,0,2,4,6956,0,0.106814261,743
Region II (Cagayan Valley),PH020000000,Cagayan,PH021500000,Enrile,PH021512000,7537,6122,583,1,62,759,0,0,0,2,7529,8,0.10107584,761
Region II (Cagayan Valley),PH020000000,Cagayan,PH021500000,Gattaran,PH021513000,12549,9037,2920,7,17,530,5,0,2,1,12519,30,0.042974678,538
Region II (Cagayan Valley),PH020000000,Cagayan,PH021500000,Gonzaga,PH021514000,8502,6785,1278,17,32,347,15,0,3,16,8493,9,0.044860473,381
Region II (Cagayan Valley),PH020000000,Cagayan,PH021500000,Iguig,PH021515000,6070,4858,957,4,14,211,3,1,3,2,6053,17,0.036180406,219
Region II (Cagayan Valley),PH020000000,Cagayan,PH021500000,Lal-Lo,PH021516000,10143,7629,2115,11,25,324,17,0,6,3,10130,13,0.034550839,350
Region II (Cagayan Valley),PH020000000,Cagayan,PH021500000,Lasam,PH021517000,8862,6289,2296,7,3,220,22,0,3,4,8844,18,0.028154681,249
Region II (Cagayan Valley),PH020000000,Cagayan,PH021500000,Pamplona,PH021518000,5074,2961,690,2,221,1193,5,0,1,1,5074,0,0.236499803,1200
Region II (Cagayan Valley),PH020000000,Cagayan,PH021500000,Peñablanca,PH021519000,10681,7555,2707,45,12,332,5,1,0,4,10661,20,0.031985742,341
Region II (Cagayan Valley),PH020000000,Cagayan,PH021500000,Piat,PH021520000,5515,3802,1334,3,30,329,2,0,2,2,5504,11,0.060864826,335
Region II (Cagayan Valley),PH020000000,Cagayan,PH021500000,Rizal,PH021521000,4033,2052,1167,11,17,741,15,0,10,12,4025,8,0.193291925,778
Region II (Cagayan Valley),PH020000000,Cagayan,PH021500000,Sanchez-Mira,PH021522000,5594,4115,239,5,470,733,25,2,1,2,5592,2,0.136087268,761
Region II (Cagayan Valley),PH020000000,Cagayan,PH021500000,Santa Ana,PH021523000,7723,5498,1291,14,64,821,5,2,9,7,7711,12,0.109194657,842
Region II (Cagayan Valley),PH020000000,Cagayan,PH021500000,Santa Praxedes,PH021524000,980,632,46,0,74,219,7,0,0,0,978,2,0.231083845,226
Region II (Cagayan Valley),PH020000000,Cagayan,PH021500000,Santa Teresita,PH021525000,4282,3253,671,4,29,284,1,3,2,2,4249,33,0.068016004,289
Region II (Cagayan Valley),PH020000000,Cagayan,PH021500000,Santo Niño (Faire),PH021526000,6439,3434,2600,6,12,343,1,0,6,2,6404,35,0.054965646,352
Region II (Cagayan Valley),PH020000000,Cagayan,PH021500000,Solana,PH021527000,18594,13495,2884,28,143,1979,24,2,8,6,18569,25,0.108621897,2017
Region II (Cagayan Valley),PH020000000,Cagayan,PH021500000,Tuao,PH021528000,13540,10102,2432,109,34,763,14,4,27,17,13502,38,0.060805807,821
Region II (Cagayan Valley),PH020000000,Cagayan,PH021500000,Tuguegarao City (Capital),PH021529000,32674,29886,2177,30,58,458,6,17,10,14,32656,18,0.014943655,488
Region II (Cagayan Valley),PH020000000,Isabela,PH023100000,Alicia,PH023101000,16888,13805,2435,90,40,333,5,3,5,27,16743,145,0.022098788,370
Region II (Cagayan Valley),PH020000000,Isabela,PH023100000,Angadanan,PH023102000,9834,7432,1807,14,26,489,0,0,1,4,9773,61,0.050547427,494
Region II (Cagayan Valley),PH020000000,Isabela,PH023100000,Aurora,PH023103000,8434,7093,1022,18,14,178,1,2,25,9,8362,72,0.025472375,213
Region II (Cagayan Valley),PH020000000,Isabela,PH023100000,Benito Soliven,PH023104000,6858,4419,2159,8,11,207,1,1,0,2,6808,50,0.030846063,210
Region II (Cagayan Valley),PH020000000,Isabela,PH023100000,Burgos,PH023105000,5672,4618,725,11,28,251,5,1,7,0,5646,26,0.046581651,263
Region II (Cagayan Valley),PH020000000,Isabela,PH023100000,Cabagan,PH023106000,9866,7777,1565,4,26,443,1,1,7,4,9828,38,0.046296296,455
Region II (Cagayan Valley),PH020000000,Isabela,PH023100000,Cabatuan,PH023107000,9036,8032,650,21,18,271,6,0,3,7,9008,28,0.031860568,287
Region II (Cagayan Valley),PH020000000,Isabela,PH023100000,City of Cauayan,PH023108000,30207,24579,4468,64,68,835,10,2,10,38,30074,133,0.029693423,893
Region II (Cagayan Valley),PH020000000,Isabela,PH023100000,City of Santiago,PH023135000,30158,24782,4070,170,69,620,25,8,29,174,29947,211,0.028316693,848
Region II (Cagayan Valley),PH020000000,Isabela,PH023100000,Cordon,PH023109000,10264,8137,1299,8,84,687,2,0,3,0,10220,44,0.067710372,692
Region II (Cagayan Valley),PH020000000,Isabela,PH023100000,Delfin Albano (Magsaysay),PH023118000,6554,5416,622,2,44,430,1,1,0,0,6516,38,0.066144874,431
Region II (Cagayan Valley),PH020000000,Isabela,PH023100000,Dinapigue,PH023110000,1229,631,367,2,6,181,3,1,22,2,1215,14,0.171193416,208
Region II (Cagayan Valley),PH020000000,Isabela,PH023100000,Divilacan,PH023111000,1260,397,657,1,0,182,1,0,0,2,1240,20,0.149193548,185
Region II (Cagayan Valley),PH020000000,Isabela,PH023100000,Echague,PH023112000,18536,14509,2527,16,63,1363,6,4,2,2,18492,44,0.074248324,1373
Region II (Cagayan Valley),PH020000000,Isabela,PH023100000,Gamu,PH023113000,6666,5676,638,4,52,278,0,0,2,0,6650,16,0.042105263,280
Region II (Cagayan Valley),PH020000000,Isabela,PH023100000,City of Ilagan (Capital),PH023114000,33887,28614,4298,69,89,636,18,2,7,21,33754,133,0.020205013,682
Region II (Cagayan Valley),PH020000000,Isabela,PH023100000,Jones,PH023115000,10543,7756,2151,47,16,450,16,2,10,27,10475,68,0.048019093,503
Region II (Cagayan Valley),PH020000000,Isabela,PH023100000,Luna,PH023116000,4486,4017,353,12,4,63,4,1,5,3,4462,24,0.016808606,75
Region II (Cagayan Valley),PH020000000,Isabela,PH023100000,Maconacon,PH023117000,935,338,518,1,1,73,0,0,3,0,934,1,0.08137045,76
Region II (Cagayan Valley),PH020000000,Isabela,PH023100000,Mallig,PH023119000,7588,5442,1035,48,138,883,11,3,11,10,7581,7,0.120696478,915
Region II (Cagayan Valley),PH020000000,Isabela,PH023100000,Naguilian,PH023120000,7299,5510,1222,0,41,506,1,0,0,1,7281,18,0.069770636,508
Region II (Cagayan Valley),PH020000000,Isabela,PH023100000,Palanan,PH023121000,3818,1116,1876,1,15,763,2,0,5,6,3784,34,0.205073996,776
Region II (Cagayan Valley),PH020000000,Isabela,PH023100000,Quezon,PH023122000,5872,4082,722,3,127,920,2,0,1,1,5858,14,0.157733015,924
Region II (Cagayan Valley),PH020000000,Isabela,PH023100000,Quirino,PH023123000,6258,5087,541,2,105,512,4,0,2,0,6253,5,0.082840237,518
Region II (Cagayan Valley),PH020000000,Isabela,PH023100000,Ramon,PH023124000,13040,10728,1405,23,70,737,6,1,6,5,12981,59,0.058084893,754
Region II (Cagayan Valley),PH020000000,Isabela,PH023100000,Reina Mercedes,PH023125000,5828,5014,545,12,22,167,1,3,6,27,5797,31,0.034673107,201
Region II (Cagayan Valley),PH020000000,Isabela,PH023100000,Roxas,PH023126000,14149,11299,1812,118,75,635,32,2,21,55,14049,100,0.052886326,743
Region II (Cagayan Valley),PH020000000,Isabela,PH023100000,San Agustin,PH023127000,5377,4487,779,5,4,92,1,0,3,1,5372,5,0.01805659,97
Region II (Cagayan Valley),PH020000000,Isabela,PH023100000,San Guillermo,PH023128000,4595,2150,2166,0,2,257,1,0,3,0,4579,16,0.056999345,261
Region II (Cagayan Valley),PH020000000,Isabela,PH023100000,San Isidro,PH023129000,5545,4458,855,16,21,166,2,0,1,3,5522,23,0.031148135,172
Region II (Cagayan Valley),PH020000000,Isabela,PH023100000,San Manuel,PH023130000,7534,5832,1045,52,40,465,23,3,2,25,7487,47,0.068785896,515
Region II (Cagayan Valley),PH020000000,Isabela,PH023100000,San Mariano,PH023131000,11849,6791,3665,26,45,1156,16,0,12,47,11758,91,0.104694676,1231
Region II (Cagayan Valley),PH020000000,Isabela,PH023100000,San Mateo,PH023132000,15353,13626,1310,19,55,287,4,2,3,8,15314,39,0.019720517,302
Region II (Cagayan Valley),PH020000000,Isabela,PH023100000,San Pablo,PH023133000,5072,4203,609,29,7,185,2,0,1,5,5041,31,0.038286054,193
Region II (Cagayan Valley),PH020000000,Isabela,PH023100000,Santa Maria,PH023134000,4844,3360,648,5,82,687,2,0,0,5,4789,55,0.144915431,694
Region II (Cagayan Valley),PH020000000,Isabela,PH023100000,Santo Tomas,PH023136000,4903,3656,883,5,36,281,1,1,1,1,4865,38,0.058376156,284
Region II (Cagayan Valley),PH020000000,Isabela,PH023100000,Tumauini,PH023137000,14862,12245,1795,20,79,625,8,2,2,6,14782,80,0.04336355,641
Region II (Cagayan Valley),PH020000000,Nueva Vizcaya,PH025000000,Alfonso Castaneda,PH025015000,1783,884,602,2,8,283,1,0,2,0,1782,1,0.160493827,286
Region II (Cagayan Valley),PH020000000,Nueva Vizcaya,PH025000000,Ambaguio,PH025001000,3535,269,2552,1,1,703,1,0,7,0,3534,1,0.201188455,711
Region II (Cagayan Valley),PH020000000,Nueva Vizcaya,PH025000000,Aritao,PH025002000,8501,5851,2045,6,33,464,3,0,1,0,8403,98,0.055694395,468
Region II (Cagayan Valley),PH020000000,Nueva Vizcaya,PH025000000,Bagabag,PH025003000,8771,7136,1188,24,15,364,2,0,5,2,8736,35,0.042696886,373
Region II (Cagayan Valley),PH020000000,Nueva Vizcaya,PH025000000,Bambang,PH025004000,13272,10312,2401,12,18,432,5,1,2,1,13184,88,0.033373786,440
Region II (Cagayan Valley),PH020000000,Nueva Vizcaya,PH025000000,Bayombong (Capital),PH025005000,15194,12660,2216,66,11,179,11,2,2,14,15161,33,0.013587494,206
Region II (Cagayan Valley),PH020000000,Nueva Vizcaya,PH025000000,Diadi,PH025006000,4403,2572,1269,4,16,493,1,0,1,2,4358,45,0.114043139,497
Region II (Cagayan Valley),PH020000000,Nueva Vizcaya,PH025000000,Dupax Del Norte,PH025007000,6597,4434,1776,6,11,341,1,0,1,0,6570,27,0.052207002,343
Region II (Cagayan Valley),PH020000000,Nueva Vizcaya,PH025000000,Dupax Del Sur,PH025008000,4528,2737,1443,1,8,307,14,0,0,2,4512,16,0.071586879,323
Region II (Cagayan Valley),PH020000000,Nueva Vizcaya,PH025000000,Kasibu,PH025009000,8415,3486,4407,10,10,386,3,3,7,4,8316,99,0.048100048,400
Region II (Cagayan Valley),PH020000000,Nueva Vizcaya,PH025000000,Kayapa,PH025010000,5516,2382,2383,0,14,706,0,0,0,0,5485,31,0.128714676,706
Region II (Cagayan Valley),PH020000000,Nueva Vizcaya,PH025000000,Quezon,PH025011000,4917,3144,1531,1,7,228,0,0,0,0,4911,6,0.04642639,228
Region II (Cagayan Valley),PH020000000,Nueva Vizcaya,PH025000000,Santa Fe,PH025012000,3721,2201,1376,2,4,136,0,0,0,1,3720,1,0.036827957,137
Region II (Cagayan Valley),PH020000000,Nueva Vizcaya,PH025000000,Solano,PH025013000,15236,12732,2074,65,32,241,5,1,6,28,15184,52,0.018440464,280
Region II (Cagayan Valley),PH020000000,Nueva Vizcaya,PH025000000,Villaverde,PH025014000,4439,3272,992,9,4,136,1,0,3,1,4418,21,0.031914894,141
Region II (Cagayan Valley),PH020000000,Quirino,PH025700000,Aglipay,PH025701000,6540,4197,1922,2,8,398,0,0,3,2,6532,8,0.061696265,403
Region II (Cagayan Valley),PH020000000,Quirino,PH025700000,Cabarroguis (Capital),PH025702000,6822,4516,2051,2,16,227,0,2,0,1,6815,7,0.033455613,228
Region II (Cagayan Valley),PH020000000,Quirino,PH025700000,Diffun,PH025703000,12087,8435,2832,37,36,688,8,1,8,9,12054,33,0.059150489,713
Region II (Cagayan Valley),PH020000000,Quirino,PH025700000,Maddela,PH025704000,8842,6078,2489,15,15,212,4,1,7,1,8822,20,0.025391068,224
Region II (Cagayan Valley),PH020000000,Quirino,PH025700000,Nagtipunan,PH025706000,4891,1969,2662,0,3,234,0,0,0,0,4868,23,0.048069022,234
Region II (Cagayan Valley),PH020000000,Quirino,PH025700000,Saguday,PH025705000,3979,3119,605,9,23,212,2,0,1,0,3971,8,0.054142533,215
Region III (Central Luzon),PH030000000,Aurora,PH037700000,Baler (Capital),PH037701000,8760,5756,1883,9,55,962,9,4,18,4,8700,60,0.114137931,993
Region III (Central Luzon),PH030000000,Aurora,PH037700000,Casiguran,PH037702000,5684,2591,1944,24,52,1029,17,1,14,3,5675,9,0.187312775,1063
Region III (Central Luzon),PH030000000,Aurora,PH037700000,Dilasag,PH037703000,3860,1951,1386,0,18,493,0,0,6,0,3854,6,0.129475869,499
Region III (Central Luzon),PH030000000,Aurora,PH037700000,Dinalungan,PH037704000,2658,1529,555,1,35,519,0,0,1,1,2641,17,0.19727376,521
Region III (Central Luzon),PH030000000,Aurora,PH037700000,Dingalan,PH037705000,5706,3234,1543,10,52,648,6,8,70,32,5603,103,0.134927717,756
Region III (Central Luzon),PH030000000,Aurora,PH037700000,Dipaculao,PH037706000,7024,4362,1762,11,32,807,0,0,11,2,6987,37,0.117360813,820
Region III (Central Luzon),PH030000000,Aurora,PH037700000,Maria Aurora,PH037707000,9347,6552,2316,20,22,370,6,0,18,6,9310,37,0.042964554,400
Region III (Central Luzon),PH030000000,Aurora,PH037700000,San Luis,PH037708000,6027,3445,2082,20,22,367,6,1,15,15,5973,54,0.067470283,403
Region III (Central Luzon),PH030000000,Bataan,PH030800000,Abucay,PH030801000,9256,8312,688,11,23,202,0,0,1,1,9238,18,0.022082702,204
Region III (Central Luzon),PH030000000,Bataan,PH030800000,Bagac,PH030802000,6008,5133,514,1,28,325,0,0,0,0,6001,7,0.05415764,325
Region III (Central Luzon),PH030000000,Bataan,PH030800000,City of Balanga (Capital),PH030803000,20832,18929,1149,17,138,502,3,3,18,14,20773,59,0.025850864,537
Region III (Central Luzon),PH030000000,Bataan,PH030800000,Dinalupihan,PH030804000,23405,20570,1398,24,228,1092,11,3,11,14,23351,54,0.048306282,1128
Region III (Central Luzon),PH030000000,Bataan,PH030800000,Hermosa,PH030805000,14212,11609,1190,64,228,1004,20,5,8,45,14173,39,0.075989558,1077
Region III (Central Luzon),PH030000000,Bataan,PH030800000,Limay,PH030806000,15036,13124,908,107,57,521,69,12,38,127,14963,73,0.050457796,755
Region III (Central Luzon),PH030000000,Bataan,PH030800000,Mariveles,PH030807000,30691,28072,1344,150,135,634,15,21,50,183,30604,87,0.028819762,882
Region III (Central Luzon),PH030000000,Bataan,PH030800000,Morong,PH030808000,6828,4998,782,16,87,890,9,2,6,12,6802,26,0.13481329,917
Region III (Central Luzon),PH030000000,Bataan,PH030800000,Orani,PH030809000,15288,13603,1193,28,69,328,2,2,7,14,15246,42,0.023022432,351
Region III (Central Luzon),PH030000000,Bataan,PH030800000,Orion,PH030810000,11740,9332,1598,14,113,620,5,0,9,3,11694,46,0.054472379,637
Region III (Central Luzon),PH030000000,Bataan,PH030800000,Pilar,PH030811000,9251,8189,620,14,61,312,3,2,8,22,9231,20,0.037374066,345
Region III (Central Luzon),PH030000000,Bataan,PH030800000,Samal,PH030812000,7605,6593,672,7,28,279,1,0,3,2,7585,20,0.03757416,285
Region III (Central Luzon),PH030000000,Bulacan,PH031400000,Angat,PH031401000,14325,12611,1262,34,28,296,1,2,10,23,14267,58,0.023130301,330
Region III (Central Luzon),PH030000000,Bulacan,PH031400000,Balagtas (Bigaa),PH031402000,17046,15789,938,1,32,230,1,1,6,10,17008,38,0.014522578,247
Region III (Central Luzon),PH030000000,Bulacan,PH031400000,Baliuag,PH031403000,35488,33451,1657,20,39,239,0,2,24,14,35446,42,0.007814704,277
Region III (Central Luzon),PH030000000,Bulacan,PH031400000,Bocaue,PH031404000,26062,23837,1721,36,40,285,6,7,38,45,26015,47,0.014376321,374
Region III (Central Luzon),PH030000000,Bulacan,PH031400000,Bulacan,PH031405000,18019,16463,1168,36,38,199,9,7,16,51,17987,32,0.01528882,275
Region III (Central Luzon),PH030000000,Bulacan,PH031400000,Bustos,PH031406000,15949,14957,681,48,25,170,3,8,10,15,15917,32,0.01243953,198
Region III (Central Luzon),PH030000000,Bulacan,PH031400000,Calumpit,PH031407000,24219,22942,949,36,23,182,2,8,15,37,24194,25,0.009754485,236
Region III (Central Luzon),PH030000000,Bulacan,PH031400000,City of Malolos (Capital),PH031410000,56255,52559,2884,78,79,474,8,9,30,33,56154,101,0.009705453,545
Region III (Central Luzon),PH030000000,Bulacan,PH031400000,City of Meycauayan,PH031412000,49919,44822,4288,69,74,383,4,14,49,76,49779,140,0.010285462,512
Region III (Central Luzon),PH030000000,Bulacan,PH031400000,City of San Jose Del Monte,PH031420000,123530,115331,5493,314,134,1260,36,56,97,360,123081,449,0.014242653,1753
Region III (Central Luzon),PH030000000,Bulacan,PH031400000,Doña Remedios Trinidad,PH031424000,5059,2265,2120,10,10,593,4,0,9,1,5012,47,0.121109338,607
Region III (Central Luzon),PH030000000,Bulacan,PH031400000,Guiguinto,PH031408000,22769,21218,1137,42,40,200,3,3,13,36,22692,77,0.011105235,252
Region III (Central Luzon),PH030000000,Bulacan,PH031400000,Hagonoy,PH031409000,28773,25778,1814,38,143,716,9,19,34,73,28624,149,0.029066518,832
Region III (Central Luzon),PH030000000,Bulacan,PH031400000,Marilao,PH031411000,51591,47453,3392,39,16,251,9,14,110,100,51384,207,0.009146816,470
Region III (Central Luzon),PH030000000,Bulacan,PH031400000,Norzagaray,PH031413000,24396,20532,2850,14,61,746,2,26,35,39,24305,91,0.033820202,822
Region III (Central Luzon),PH030000000,Bulacan,PH031400000,Obando,PH031414000,12883,9758,2908,16,9,114,4,1,17,15,12842,41,0.011680424,150
Region III (Central Luzon),PH030000000,Bulacan,PH031400000,Pandi,PH031415000,20193,18431,1423,34,33,172,0,3,13,28,20137,56,0.010577544,213
Region III (Central Luzon),PH030000000,Bulacan,PH031400000,Paombong,PH031416000,11489,10040,710,24,207,402,11,5,30,19,11448,41,0.040356394,462
Region III (Central Luzon),PH030000000,Bulacan,PH031400000,Plaridel,PH031417000,24206,22885,1076,17,16,160,4,3,8,14,24183,23,0.007691353,186
Region III (Central Luzon),PH030000000,Bulacan,PH031400000,Pulilan,PH031418000,22279,20651,1000,53,81,313,12,8,17,57,22192,87,0.017979452,399
Region III (Central Luzon),PH030000000,Bulacan,PH031400000,San Ildefonso,PH031419000,23932,20684,2305,53,62,663,5,3,45,25,23845,87,0.030949885,738
Region III (Central Luzon),PH030000000,Bulacan,PH031400000,San Miguel,PH031421000,33729,27726,3652,243,130,1251,18,72,99,175,33366,363,0.04624468,1543
Region III (Central Luzon),PH030000000,Bulacan,PH031400000,San Rafael,PH031422000,22051,20188,1232,15,63,376,9,8,13,72,21976,75,0.021386968,470
Region III (Central Luzon),PH030000000,Bulacan,PH031400000,Santa Maria,PH031423000,57575,52319,3792,196,163,705,15,20,47,92,57349,226,0.014978465,859
Region III (Central Luzon),PH030000000,Nueva Ecija,PH034900000,Aliaga,PH034901000,13940,11877,1127,26,58,770,5,2,17,21,13903,37,0.058476588,813
Region III (Central Luzon),PH030000000,Nueva Ecija,PH034900000,Bongabon,PH034902000,14819,11991,1709,28,129,887,4,2,5,7,14762,57,0.061170573,903
Region III (Central Luzon),PH030000000,Nueva Ecija,PH034900000,City of Cabanatuan,PH034903000,66994,57534,7063,126,141,1607,17,20,110,206,66824,170,0.029031486,1940
Region III (Central Luzon),PH030000000,Nueva Ecija,PH034900000,Cabiao,PH034904000,16511,14965,809,43,48,526,14,6,17,20,16448,63,0.035080253,577
Region III (Central Luzon),PH030000000,Nueva Ecija,PH034900000,Carranglan,PH034905000,9588,5553,2021,1,87,1885,3,0,7,2,9559,29,0.198451721,1897
Region III (Central Luzon),PH030000000,Nueva Ecija,PH034900000,City of Gapan,PH034908000,24586,20536,2636,131,121,855,14,4,27,185,24509,77,0.044106247,1081
Region III (Central Luzon),PH030000000,Nueva Ecija,PH034900000,Cuyapo,PH034906000,15003,10669,2059,8,132,2064,4,1,1,4,14942,61,0.138736448,2073
Region III (Central Luzon),PH030000000,Nueva Ecija,PH034900000,Gabaldon (Bitulok & Sabani),PH034907000,8484,5734,743,2,205,1741,3,0,3,0,8431,53,0.207211481,1747
Region III (Central Luzon),PH030000000,Nueva Ecija,PH034900000,General Mamerto Natividad,PH034909000,9320,6934,1488,42,27,622,6,2,23,32,9176,144,0.074433304,683
Region III (Central Luzon),PH030000000,Nueva Ecija,PH034900000,General Tinio (Papaya),PH034910000,10305,8472,1341,11,13,409,1,0,4,14,10265,40,0.04169508,428
Region III (Central Luzon),PH030000000,Nueva Ecija,PH034900000,Guimba,PH034911000,28325,22269,3772,24,121,2013,2,4,26,25,28256,69,0.073117214,2066
Region III (Central Luzon),PH030000000,Nueva Ecija,PH034900000,Jaen,PH034912000,17602,14818,1712,24,61,884,5,5,21,25,17555,47,0.053261179,935
Region III (Central Luzon),PH030000000,Nueva Ecija,PH034900000,Laur,PH034913000,8522,5662,1083,2,112,1594,2,0,6,7,8468,54,0.190009447,1609
Region III (Central Luzon),PH030000000,Nueva Ecija,PH034900000,Licab,PH034914000,6374,4569,1060,7,84,610,0,0,4,4,6338,36,0.0975071,618
Region III (Central Luzon),PH030000000,Nueva Ecija,PH034900000,Llanera,PH034915000,9552,7345,1227,15,66,751,7,2,25,17,9455,97,0.084611317,800
Region III (Central Luzon),PH030000000,Nueva Ecija,PH034900000,Lupao,PH034916000,9987,7458,1210,10,118,1105,10,6,10,6,9933,54,0.113862881,1131
Region III (Central Luzon),PH030000000,Nueva Ecija,PH034900000,Nampicuan,PH034918000,3018,2326,327,1,35,324,0,0,0,1,3014,4,0.107830126,325
Region III (Central Luzon),PH030000000,Nueva Ecija,PH034900000,City of Palayan (Capital),PH034919000,9280,6911,961,8,114,1237,2,0,7,10,9250,30,0.135783784,1256
Region III (Central Luzon),PH030000000,Nueva Ecija,PH034900000,Pantabangan,PH034920000,6107,4092,1260,1,54,681,1,0,2,0,6091,16,0.112296831,684
Region III (Central Luzon),PH030000000,Nueva Ecija,PH034900000,Peñaranda,PH034921000,6819,5672,765,26,8,193,18,1,48,20,6751,68,0.041327211,279
Region III (Central Luzon),PH030000000,Nueva Ecija,PH034900000,Quezon,PH034922000,9443,7422,1133,37,74,637,11,5,13,51,9383,60,0.075881914,712
Region III (Central Luzon),PH030000000,Nueva Ecija,PH034900000,Rizal,PH034923000,14751,11272,1370,19,198,1771,24,4,9,20,14687,64,0.124191462,1824
Region III (Central Luzon),PH030000000,Nueva Ecija,PH034900000,San Antonio,PH034924000,17419,14842,1783,59,48,491,7,6,42,52,17330,89,0.034160415,592
Region III (Central Luzon),PH030000000,Nueva Ecija,PH034900000,San Isidro,PH034925000,11312,9785,1056,67,32,239,2,5,15,46,11247,65,0.026851605,302
Region III (Central Luzon),PH030000000,Nueva Ecija,PH034900000,San Jose City,PH034926000,32328,25741,4726,69,112,1394,10,4,55,36,32147,181,0.046505117,1495
Region III (Central Luzon),PH030000000,Nueva Ecija,PH034900000,San Leonardo,PH034927000,14690,12161,1798,50,59,397,14,10,36,52,14577,113,0.034232009,499
Region III (Central Luzon),PH030000000,Nueva Ecija,PH034900000,Santa Rosa,PH034928000,15659,13298,1614,77,35,488,12,8,29,46,15607,52,0.036842442,575
Region III (Central Luzon),PH030000000,Nueva Ecija,PH034900000,Santo Domingo,PH034929000,14071,10887,1971,22,70,1010,7,1,13,35,14016,55,0.075984589,1065
Region III (Central Luzon),PH030000000,Nueva Ecija,PH034900000,Science City of Muñoz,PH034917000,18907,15215,2193,52,61,1185,6,13,19,34,18778,129,0.066247737,1244
Region III (Central Luzon),PH030000000,Nueva Ecija,PH034900000,Talavera,PH034930000,27987,24288,2560,32,165,693,5,5,21,31,27800,187,0.026978417,750
Region III (Central Luzon),PH030000000,Nueva Ecija,PH034900000,Talugtug,PH034931000,5776,3248,1040,2,61,1403,1,1,4,2,5762,14,0.244706699,1410
Region III (Central Luzon),PH030000000,Nueva Ecija,PH034900000,Zaragoza,PH034932000,10982,8785,1312,10,58,775,6,1,5,11,10963,19,0.072699079,797
Region III (Central Luzon),PH030000000,Pampanga,PH035400000,City of Angeles,PH035401000,94666,89960,3404,20,105,781,6,17,50,184,94527,139,0.010801147,1021
Region III (Central Luzon),PH030000000,Pampanga,PH035400000,Apalit,PH035402000,22801,21770,672,8,64,248,3,4,3,6,22778,23,0.011414523,260
Region III (Central Luzon),PH030000000,Pampanga,PH035400000,Arayat,PH035403000,27433,24303,1548,25,382,1009,4,18,73,43,27405,28,0.041196862,1129
Region III (Central Luzon),PH030000000,Pampanga,PH035400000,Bacolor,PH035404000,9375,8604,462,7,28,210,0,2,6,31,9350,25,0.026417112,247
Region III (Central Luzon),PH030000000,Pampanga,PH035400000,Candaba,PH035405000,22428,19938,1468,78,80,649,5,7,24,89,22338,90,0.034336109,767
Region III (Central Luzon),PH030000000,Pampanga,PH035400000,City of San Fernando (Capital),PH035416000,66370,62847,2123,52,327,573,4,37,22,148,66133,237,0.01129542,747
Region III (Central Luzon),PH030000000,Pampanga,PH035400000,Floridablanca,PH035406000,28196,24364,851,12,331,2549,4,6,4,24,28145,51,0.091703677,2581
Region III (Central Luzon),PH030000000,Pampanga,PH035400000,Guagua,PH035407000,24964,23004,1546,8,41,290,0,4,6,38,24937,27,0.013393752,334
Region III (Central Luzon),PH030000000,Pampanga,PH035400000,Lubao,PH035408000,33868,30243,2075,61,301,1015,8,10,14,81,33808,60,0.033069096,1118
Region III (Central Luzon),PH030000000,Pampanga,PH035400000,Mabalacat City,PH035409000,55991,53197,1821,26,65,754,7,5,9,34,55918,73,0.014378197,804
Region III (Central Luzon),PH030000000,Pampanga,PH035400000,Macabebe,PH035410000,15856,13493,1967,9,76,270,2,10,9,3,15839,17,0.017930425,284
Region III (Central Luzon),PH030000000,Pampanga,PH035400000,Magalang,PH035411000,23821,22177,751,6,128,701,1,1,5,9,23779,42,0.030110602,716
Region III (Central Luzon),PH030000000,Pampanga,PH035400000,Masantol,PH035412000,11665,8838,2244,22,49,459,2,3,14,4,11635,30,0.041168887,479
Region III (Central Luzon),PH030000000,Pampanga,PH035400000,Mexico,PH035413000,31281,29560,917,7,143,617,1,2,3,6,31256,25,0.020060148,627
Region III (Central Luzon),PH030000000,Pampanga,PH035400000,Minalin,PH035414000,9527,8273,924,6,26,245,0,1,25,5,9505,22,0.028932141,275
Region III (Central Luzon),PH030000000,Pampanga,PH035400000,Porac,PH035415000,27156,24930,798,52,113,1149,14,8,12,45,27121,35,0.044983592,1220
Region III (Central Luzon),PH030000000,Pampanga,PH035400000,San Luis,PH035417000,10865,9629,1070,2,23,129,0,1,7,0,10861,4,0.012521867,136
Region III (Central Luzon),PH030000000,Pampanga,PH035400000,San Simon,PH035418000,11226,10248,737,2,32,177,0,1,1,0,11198,28,0.015895696,178
Region III (Central Luzon),PH030000000,Pampanga,PH035400000,Santa Ana,PH035419000,10636,10043,335,3,32,211,0,0,1,2,10627,9,0.020137386,214
Region III (Central Luzon),PH030000000,Pampanga,PH035400000,Santa Rita,PH035420000,8830,8000,548,16,39,174,3,0,3,8,8791,39,0.021385508,188
Region III (Central Luzon),PH030000000,Pampanga,PH035400000,Santo Tomas,PH035421000,8675,7597,987,1,6,73,0,0,0,0,8664,11,0.008425669,73
Region III (Central Luzon),PH030000000,Pampanga,PH035400000,Sasmuan (Sexmoan),PH035422000,5584,4684,415,74,21,134,1,4,5,207,5545,39,0.0625789,347
Region III (Central Luzon),PH030000000,Tarlac,PH036900000,Anao,PH036901000,2685,2237,346,1,2,82,0,0,1,0,2669,16,0.031097789,83
Region III (Central Luzon),PH030000000,Tarlac,PH036900000,Bamban,PH036902000,14739,13398,544,21,85,622,9,7,13,28,14727,12,0.045630475,672
Region III (Central Luzon),PH030000000,Tarlac,PH036900000,Camiling,PH036903000,19262,14903,3737,20,36,458,2,2,6,5,19169,93,0.024570922,471
Region III (Central Luzon),PH030000000,Tarlac,PH036900000,Capas,PH036904000,30762,25949,1826,47,165,2610,17,4,3,27,30648,114,0.086694075,2657
Region III (Central Luzon),PH030000000,Tarlac,PH036900000,City of Tarlac (Capital),PH036916000,74429,67288,4376,233,252,1801,27,10,39,207,74233,196,0.027939057,2074
Region III (Central Luzon),PH030000000,Tarlac,PH036900000,Concepcion,PH036905000,32539,29975,1623,26,144,654,8,9,23,34,32496,43,0.0221258,719
Region III (Central Luzon),PH030000000,Tarlac,PH036900000,Gerona,PH036906000,21157,17579,2231,40,100,970,10,12,12,109,21063,94,0.052271756,1101
Region III (Central Luzon),PH030000000,Tarlac,PH036900000,La Paz,PH036907000,13885,11730,1252,56,81,562,4,7,28,30,13750,135,0.045381818,624
Region III (Central Luzon),PH030000000,Tarlac,PH036900000,Mayantoc,PH036908000,7456,5701,1134,14,47,539,0,0,2,6,7443,13,0.073491872,547
Region III (Central Luzon),PH030000000,Tarlac,PH036900000,Moncada,PH036909000,13314,10528,2063,37,37,497,8,2,6,10,13188,126,0.039505611,521
Region III (Central Luzon),PH030000000,Tarlac,PH036900000,Paniqui,PH036910000,22013,18376,2573,16,83,842,4,2,4,9,21909,104,0.039207632,859
Region III (Central Luzon),PH030000000,Tarlac,PH036900000,Pura,PH036911000,5585,4788,458,4,64,224,0,1,11,7,5557,28,0.043548677,242
Region III (Central Luzon),PH030000000,Tarlac,PH036900000,Ramos,PH036912000,4710,3944,287,0,71,388,5,1,3,1,4700,10,0.084468085,397
Region III (Central Luzon),PH030000000,Tarlac,PH036900000,San Clemente,PH036913000,3017,2275,592,0,3,123,0,0,0,1,2994,23,0.041416166,124
Region III (Central Luzon),PH030000000,Tarlac,PH036900000,San Jose,PH036918000,8357,5349,1957,9,44,948,2,0,1,6,8316,41,0.115079365,957
Region III (Central Luzon),PH030000000,Tarlac,PH036900000,San Manuel,PH036914000,5645,4718,528,11,35,318,5,1,1,2,5619,26,0.058017441,326
Region III (Central Luzon),PH030000000,Tarlac,PH036900000,Santa Ignacia,PH036915000,11454,8832,1939,12,33,584,1,1,4,10,11416,38,0.052470217,599
Region III (Central Luzon),PH030000000,Tarlac,PH036900000,Victoria,PH036917000,15035,12685,1414,47,69,718,14,5,16,17,14985,50,0.051051051,765
Region III (Central Luzon),PH030000000,Zambales,PH037100000,Botolan,PH037101000,13627,9904,888,37,108,2570,48,6,3,31,13595,32,0.195071718,2652
Region III (Central Luzon),PH030000000,Zambales,PH037100000,Cabangan,PH037102000,5966,4569,376,9,116,811,9,4,8,37,5939,27,0.145647415,865
Region III (Central Luzon),PH030000000,Zambales,PH037100000,Candelaria,PH037103000,6034,4524,973,2,20,484,1,0,0,1,6005,29,0.080932556,486
Region III (Central Luzon),PH030000000,Zambales,PH037100000,Castillejos,PH037104000,16636,14726,936,19,116,723,10,2,4,43,16579,57,0.04704747,780
Region III (Central Luzon),PH030000000,Zambales,PH037100000,Iba (Capital),PH037105000,11450,9655,735,21,73,892,2,1,2,35,11416,34,0.081552207,931
Region III (Central Luzon),PH030000000,Zambales,PH037100000,Masinloc,PH037106000,10620,7562,1647,44,68,1175,4,3,28,12,10543,77,0.11562174,1219
Region III (Central Luzon),PH030000000,Zambales,PH037100000,City of Olongapo,PH037107000,55265,51164,2875,114,77,578,18,25,98,187,55136,129,0.015978671,881
Region III (Central Luzon),PH030000000,Zambales,PH037100000,Palauig,PH037108000,7857,5757,657,24,140,1221,12,2,3,7,7823,34,0.158890451,1243
Region III (Central Luzon),PH030000000,Zambales,PH037100000,San Antonio,PH037109000,8572,7143,767,21,61,515,3,0,8,21,8539,33,0.064059023,547
Region III (Central Luzon),PH030000000,Zambales,PH037100000,San Felipe,PH037110000,5585,4437,364,7,96,651,3,0,2,9,5569,16,0.119411025,665
Region III (Central Luzon),PH030000000,Zambales,PH037100000,San Marcelino,PH037111000,8019,6552,570,17,73,716,9,11,7,14,7969,50,0.093612749,746
Region III (Central Luzon),PH030000000,Zambales,PH037100000,San Narciso,PH037112000,7038,5708,757,30,42,447,3,1,2,8,6998,40,0.065733067,460
Region III (Central Luzon),PH030000000,Zambales,PH037100000,Santa Cruz,PH037113000,13680,10222,1837,72,74,1286,27,2,12,19,13551,129,0.099180872,1344
Region III (Central Luzon),PH030000000,Zambales,PH037100000,Subic,PH037114000,24760,20254,1984,104,218,1750,56,10,150,103,24629,131,0.083600633,2059
Region IV-A (CALABARZON),PH040000000,Batangas,PH041000000,Agoncillo,PH041001000,7806,6896,590,2,22,255,3,1,3,2,7774,32,0.033830718,263
Region IV-A (CALABARZON),PH040000000,Batangas,PH041000000,Alitagtag,PH041002000,5089,4314,504,16,13,217,2,0,2,6,5074,15,0.044737879,227
Region IV-A (CALABARZON),PH040000000,Batangas,PH041000000,Balayan,PH041003000,20414,18231,1220,35,93,682,4,2,27,29,20323,91,0.036510358,742
Region IV-A (CALABARZON),PH040000000,Batangas,PH041000000,Balete,PH041004000,4580,4000,369,21,12,112,0,2,2,57,4575,5,0.037377049,171
Region IV-A (CALABARZON),PH040000000,Batangas,PH041000000,Batangas City (Capital),PH041005000,75485,65829,6902,71,187,1954,15,12,90,65,75125,360,0.028272879,2124
Region IV-A (CALABARZON),PH040000000,Batangas,PH041000000,Bauan,PH041006000,20241,18552,1344,28,28,247,5,1,4,4,20213,28,0.012863009,260
Region IV-A (CALABARZON),PH040000000,Batangas,PH041000000,Calaca,PH041007000,17707,15961,1179,12,60,414,3,0,24,17,17670,37,0.025919638,458
Region IV-A (CALABARZON),PH040000000,Batangas,PH041000000,Calatagan,PH041008000,13337,10817,1391,16,142,899,9,5,4,22,13305,32,0.070199173,934
Region IV-A (CALABARZON),PH040000000,Batangas,PH041000000,City of Tanauan,PH041031000,37426,34007,1908,167,83,695,11,39,35,295,37240,186,0.027819549,1036
Region IV-A (CALABARZON),PH040000000,Batangas,PH041000000,Cuenca,PH041009000,7160,6136,791,21,37,139,0,1,3,4,7132,28,0.020471116,146
Region IV-A (CALABARZON),PH040000000,Batangas,PH041000000,Ibaan,PH041010000,12005,10468,1231,6,36,229,1,1,10,8,11990,15,0.020683903,248
Region IV-A (CALABARZON),PH040000000,Batangas,PH041000000,Laurel,PH041011000,8551,7260,938,25,18,250,2,4,19,14,8530,21,0.033411489,285
Region IV-A (CALABARZON),PH040000000,Batangas,PH041000000,Lemery,PH041012000,19635,17068,1553,29,89,751,4,14,33,24,19565,70,0.041502683,812
Region IV-A (CALABARZON),PH040000000,Batangas,PH041000000,Lian,PH041013000,12507,10099,1387,15,99,809,4,15,3,12,12443,64,0.066543438,828
Region IV-A (CALABARZON),PH040000000,Batangas,PH041000000,City of Lipa,PH041014000,72177,67041,4131,133,85,548,9,8,42,51,72048,129,0.009021763,650
Region IV-A (CALABARZON),PH040000000,Batangas,PH041000000,Lobo,PH041015000,8945,6541,1863,14,21,434,1,0,5,4,8883,62,0.049983114,444
Region IV-A (CALABARZON),PH040000000,Batangas,PH041000000,Mabini,PH041016000,9757,8092,1098,23,66,412,10,0,34,9,9744,13,0.047721675,465
Region IV-A (CALABARZON),PH040000000,Batangas,PH041000000,Malvar,PH041017000,12833,11487,1066,22,6,95,1,8,26,98,12809,24,0.017175424,220
Region IV-A (CALABARZON),PH040000000,Batangas,PH041000000,Mataasnakahoy,PH041018000,6415,5694,501,3,12,109,1,17,15,44,6396,19,0.026422764,169
Region IV-A (CALABARZON),PH040000000,Batangas,PH041000000,Nasugbu,PH041019000,30482,24505,4003,72,132,1498,25,17,47,88,30387,95,0.054562806,1658
Region IV-A (CALABARZON),PH040000000,Batangas,PH041000000,Padre Garcia,PH041020000,10782,9622,943,34,28,95,2,1,9,10,10744,38,0.010796724,116
Region IV-A (CALABARZON),PH040000000,Batangas,PH041000000,Rosario,PH041021000,25971,21040,4013,64,54,570,6,2,35,25,25809,162,0.024642567,636
Region IV-A (CALABARZON),PH040000000,Batangas,PH041000000,San Jose,PH041022000,17972,16043,1417,5,55,381,2,2,6,47,17958,14,0.024278873,436
Region IV-A (CALABARZON),PH040000000,Batangas,PH041000000,San Juan,PH041023000,23713,17099,5496,68,94,805,5,4,10,11,23592,121,0.035223805,831
Region IV-A (CALABARZON),PH040000000,Batangas,PH041000000,San Luis,PH041024000,7218,5983,861,0,18,309,0,5,8,2,7186,32,0.044391873,319
Region IV-A (CALABARZON),PH040000000,Batangas,PH041000000,San Nicolas,PH041025000,4473,3653,361,4,8,445,0,1,1,0,4473,0,0.099709367,446
Region IV-A (CALABARZON),PH040000000,Batangas,PH041000000,San Pascual,PH041026000,14589,13411,840,17,35,249,2,4,6,3,14567,22,0.017848562,260
Region IV-A (CALABARZON),PH040000000,Batangas,PH041000000,Santa Teresita,PH041027000,4218,3626,409,2,7,148,1,0,0,1,4194,24,0.035765379,150
Region IV-A (CALABARZON),PH040000000,Batangas,PH041000000,Santo Tomas,PH041028000,42118,38401,2285,127,99,988,11,12,38,100,42061,57,0.027032168,1137
Region IV-A (CALABARZON),PH040000000,Batangas,PH041000000,Taal,PH041029000,11900,10484,831,8,51,409,0,10,7,71,11871,29,0.041024345,487
Region IV-A (CALABARZON),PH040000000,Batangas,PH041000000,Talisay,PH041030000,9685,8505,814,4,17,304,1,0,10,8,9663,22,0.033426472,323
Region IV-A (CALABARZON),PH040000000,Batangas,PH041000000,Taysan,PH041032000,8479,6491,1403,11,28,498,1,1,8,10,8451,28,0.061176192,517
Region IV-A (CALABARZON),PH040000000,Batangas,PH041000000,Tingloy,PH041033000,4054,2623,363,3,97,942,6,0,0,0,4034,20,0.235002479,948
Region IV-A (CALABARZON),PH040000000,Batangas,PH041000000,Tuy,PH041034000,10034,8326,1220,17,156,273,6,0,11,10,10019,15,0.029943108,300
Region IV-A (CALABARZON),PH040000000,Cavite,PH042100000,Alfonso,PH042101000,11762,10668,778,28,21,230,3,6,3,5,11742,20,0.020524613,241
Region IV-A (CALABARZON),PH040000000,Cavite,PH042100000,Amadeo,PH042102000,8761,7883,662,40,10,89,3,1,10,13,8711,50,0.013201699,115
Region IV-A (CALABARZON),PH040000000,Cavite,PH042100000,City of Bacoor,PH042103000,144707,120799,19878,163,190,2211,19,102,223,271,143856,851,0.018935602,2724
Region IV-A (CALABARZON),PH040000000,Cavite,PH042100000,Carmona,PH042104000,23448,21346,1496,173,14,103,16,24,27,66,23265,183,0.009112401,212
Region IV-A (CALABARZON),PH040000000,Cavite,PH042100000,City of Cavite,PH042105000,23828,16087,7206,24,10,370,4,3,16,74,23794,34,0.019500714,464
Region IV-A (CALABARZON),PH040000000,Cavite,PH042100000,City of Dasmariñas,PH042106000,145166,136331,7113,244,87,468,9,139,148,305,144844,322,0.006420701,930
Region IV-A (CALABARZON),PH040000000,Cavite,PH042100000,City of General Trias,PH042108000,76687,72051,3788,133,38,230,15,31,84,149,76519,168,0.006246815,478
Region IV-A (CALABARZON),PH040000000,Cavite,PH042100000,Gen. Mariano Alvarez,PH042123000,33914,31454,1849,136,19,138,6,14,32,126,33774,140,0.00894179,302
Region IV-A (CALABARZON),PH040000000,Cavite,PH042100000,General Emilio Aguinaldo,PH042107000,4365,3790,533,3,4,25,0,0,0,0,4355,10,0.005740528,25
Region IV-A (CALABARZON),PH040000000,Cavite,PH042100000,City of Imus,PH042109000,95234,88703,5290,171,93,255,5,30,218,278,95043,191,0.007954294,756
Region IV-A (CALABARZON),PH040000000,Cavite,PH042100000,Indang,PH042110000,14797,13095,1365,64,9,154,2,8,23,16,14736,61,0.013232899,195
Region IV-A (CALABARZON),PH040000000,Cavite,PH042100000,Kawit,PH042111000,19510,15532,3322,87,86,229,30,4,23,133,19446,64,0.02134115,415
Region IV-A (CALABARZON),PH040000000,Cavite,PH042100000,Magallanes,PH042112000,4766,3575,1102,29,6,22,0,0,4,1,4739,27,0.005697405,27
Region IV-A (CALABARZON),PH040000000,Cavite,PH042100000,Maragondon,PH042113000,8201,6163,1561,82,12,278,4,4,15,24,8143,58,0.039420361,321
Region IV-A (CALABARZON),PH040000000,Cavite,PH042100000,Mendez (Mendez-Nuñez),PH042114000,7016,6345,559,8,17,64,0,0,7,6,7006,10,0.01099058,77
Region IV-A (CALABARZON),PH040000000,Cavite,PH042100000,Naic,PH042115000,25703,21550,2994,85,99,775,5,5,32,64,25609,94,0.034206724,876
Region IV-A (CALABARZON),PH040000000,Cavite,PH042100000,Noveleta,PH042116000,11088,9813,1050,22,8,113,16,4,12,33,11071,17,0.015716737,174
Region IV-A (CALABARZON),PH040000000,Cavite,PH042100000,Rosario,PH042117000,27856,24667,2554,68,33,336,28,14,33,97,27830,26,0.017750629,494
Region IV-A (CALABARZON),PH040000000,Cavite,PH042100000,Silang,PH042118000,56961,51378,4028,308,79,585,22,15,56,184,56655,306,0.014950137,847
Region IV-A (CALABARZON),PH040000000,Cavite,PH042100000,City of Tagaytay,PH042119000,15969,14135,1164,158,12,80,4,20,17,283,15873,96,0.024192024,384
Region IV-A (CALABARZON),PH040000000,Cavite,PH042100000,Tanza,PH042120000,53692,47410,4754,69,365,701,23,5,115,62,53504,188,0.016839862,901
Region IV-A (CALABARZON),PH040000000,Cavite,PH042100000,Ternate,PH042121000,5645,3821,1308,16,15,402,1,6,9,43,5621,24,0.080946451,455
Region IV-A (CALABARZON),PH040000000,Cavite,PH042100000,City of Trece Martires (Capital),PH042122000,32795,30791,1370,91,31,298,8,7,20,73,32689,106,0.012205941,399
Region IV-A (CALABARZON),PH040000000,Laguna,PH043400000,Alaminos,PH043401000,11025,9183,1370,45,23,358,5,2,4,22,11012,13,0.0353251,389
Region IV-A (CALABARZON),PH040000000,Laguna,PH043400000,Bay,PH043402000,14987,12525,1967,74,47,262,5,4,42,21,14947,40,0.022078009,330
Region IV-A (CALABARZON),PH040000000,Laguna,PH043400000,City of Cabuyao,PH043404000,78730,75553,2589,69,37,235,3,10,32,72,78600,130,0.004351145,342
Region IV-A (CALABARZON),PH040000000,Laguna,PH043400000,Calauan,PH043406000,17591,15404,1841,34,76,174,4,10,11,3,17557,34,0.010935809,192
Region IV-A (CALABARZON),PH040000000,Laguna,PH043400000,Cavinti,PH043407000,5355,4038,929,4,13,344,0,2,3,1,5334,21,0.065241845,348
Region IV-A (CALABARZON),PH040000000,Laguna,PH043400000,City of Biñan,PH043403000,82168,74140,6221,63,57,467,10,49,94,286,81387,781,0.010529937,857
Region IV-A (CALABARZON),PH040000000,Laguna,PH043400000,City of Calamba,PH043405000,113431,102316,9306,274,117,631,13,31,143,325,113156,275,0.009827141,1112
Region IV-A (CALABARZON),PH040000000,Laguna,PH043400000,City of San Pedro,PH043425000,71496,66217,4567,97,17,106,25,59,114,201,71403,93,0.006246236,446
Region IV-A (CALABARZON),PH040000000,Laguna,PH043400000,City of Santa Rosa,PH043428000,94323,88919,4563,101,73,344,3,9,44,114,94170,153,0.005362642,505
Region IV-A (CALABARZON),PH040000000,Laguna,PH043400000,Famy,PH043408000,3611,2368,1143,22,1,41,1,0,7,2,3585,26,0.014225941,51
Region IV-A (CALABARZON),PH040000000,Laguna,PH043400000,Kalayaan,PH043409000,5109,3125,1684,24,1,94,1,2,64,43,5038,71,0.040095276,202
Region IV-A (CALABARZON),PH040000000,Laguna,PH043400000,Liliw,PH043410000,8990,7126,1198,41,21,395,3,37,63,25,8909,81,0.054551577,486
Region IV-A (CALABARZON),PH040000000,Laguna,PH043400000,Los Baños,PH043411000,27722,24837,2226,45,37,380,10,5,121,26,27687,35,0.019395384,537
Region IV-A (CALABARZON),PH040000000,Laguna,PH043400000,Luisiana,PH043412000,4635,4073,478,4,5,59,1,2,7,0,4629,6,0.014473968,67
Region IV-A (CALABARZON),PH040000000,Laguna,PH043400000,Lumban,PH043413000,6933,5687,1044,12,5,76,1,0,2,0,6827,106,0.011571701,79
Region IV-A (CALABARZON),PH040000000,Laguna,PH043400000,Mabitac,PH043414000,4490,2858,1313,39,3,136,2,51,10,10,4422,68,0.035730439,158
Region IV-A (CALABARZON),PH040000000,Laguna,PH043400000,Magdalena,PH043415000,5754,3947,1424,8,10,289,1,2,12,8,5701,53,0.054376425,310
Region IV-A (CALABARZON),PH040000000,Laguna,PH043400000,Majayjay,PH043416000,6464,4869,1101,6,20,393,0,1,12,8,6410,54,0.064430577,413
Region IV-A (CALABARZON),PH040000000,Laguna,PH043400000,Nagcarlan,PH043417000,15212,12557,2078,19,20,389,0,5,64,6,15138,74,0.030321046,459
Region IV-A (CALABARZON),PH040000000,Laguna,PH043400000,Paete,PH043418000,5425,4274,848,20,118,105,7,2,5,11,5390,35,0.023747681,128
Region IV-A (CALABARZON),PH040000000,Laguna,PH043400000,Pagsanjan,PH043419000,9581,7960,1375,39,14,100,1,0,10,3,9502,79,0.011997474,114
Region IV-A (CALABARZON),PH040000000,Laguna,PH043400000,Pakil,PH043420000,4571,3328,1051,6,6,140,0,0,14,1,4546,25,0.034095908,155
Region IV-A (CALABARZON),PH040000000,Laguna,PH043400000,Pangil,PH043421000,5393,3694,1366,37,3,138,4,1,32,39,5314,79,0.0400828,213
Region IV-A (CALABARZON),PH040000000,Laguna,PH043400000,Pila,PH043422000,11326,9368,1724,21,12,103,0,1,7,6,11242,84,0.010318449,116
Region IV-A (CALABARZON),PH040000000,Laguna,PH043400000,Rizal,PH043423000,4061,3394,456,17,4,61,0,19,52,11,4014,47,0.030891878,124
Region IV-A (CALABARZON),PH040000000,Laguna,PH043400000,City of San Pablo,PH043424000,60788,51724,7785,169,62,835,14,4,18,41,60652,136,0.014970652,908
Region IV-A (CALABARZON),PH040000000,Laguna,PH043400000,Santa Cruz (Capital),PH043426000,27061,23004,3404,135,63,275,7,5,11,26,26930,131,0.011845525,319
Region IV-A (CALABARZON),PH040000000,Laguna,PH043400000,Santa Maria,PH043427000,6983,5006,1832,14,11,76,2,0,7,17,6965,18,0.014644652,102
Region IV-A (CALABARZON),PH040000000,Laguna,PH043400000,Siniloan,PH043429000,8315,6091,1814,28,15,302,5,1,10,9,8275,40,0.03939577,326
Region IV-A (CALABARZON),PH040000000,Laguna,PH043400000,Victoria,PH043430000,10362,9049,1113,14,10,98,0,1,4,20,10309,53,0.01183432,122
Region IV-A (CALABARZON),PH040000000,Quezon,PH045600000,Agdangan,PH045601000,3156,2164,390,22,56,476,14,0,0,3,3125,31,0.15776,493
Region IV-A (CALABARZON),PH040000000,Quezon,PH045600000,Alabat,PH045602000,3539,2176,629,4,52,626,0,0,1,1,3489,50,0.179994268,628
Region IV-A (CALABARZON),PH040000000,Quezon,PH045600000,Atimonan,PH045603000,14422,9929,2434,64,180,1664,41,8,22,23,14365,57,0.121823877,1750
Region IV-A (CALABARZON),PH040000000,Quezon,PH045600000,Buenavista,PH045605000,6754,2346,1574,30,132,2538,33,0,4,12,6669,85,0.38791423,2587
Region IV-A (CALABARZON),PH040000000,Quezon,PH045600000,Burdeos,PH045606000,5634,1243,420,9,426,3345,72,5,9,86,5615,19,0.625467498,3512
Region IV-A (CALABARZON),PH040000000,Quezon,PH045600000,Calauag,PH045607000,16451,6956,3629,29,391,5119,35,27,33,31,16250,201,0.321107692,5218
Region IV-A (CALABARZON),PH040000000,Quezon,PH045600000,Candelaria,PH045608000,26841,20820,4801,74,69,868,7,6,40,45,26730,111,0.035914703,960
Region IV-A (CALABARZON),PH040000000,Quezon,PH045600000,Catanauan,PH045610000,15231,6032,4674,23,220,4215,18,7,3,7,15199,32,0.279163103,4243
Region IV-A (CALABARZON),PH040000000,Quezon,PH045600000,City of Tayabas,PH045647000,23198,18143,3962,45,42,874,5,2,6,3,23082,116,0.038471536,888
Region IV-A (CALABARZON),PH040000000,Quezon,PH045600000,Dolores,PH045615000,6463,4960,1251,51,4,127,3,1,12,28,6437,26,0.026409818,170
Region IV-A (CALABARZON),PH040000000,Quezon,PH045600000,General Luna,PH045616000,5666,2486,1206,31,117,1697,49,1,9,16,5612,54,0.31557377,1771
Region IV-A (CALABARZON),PH040000000,Quezon,PH045600000,General Nakar,PH045617000,6357,2299,2143,1,74,1710,12,0,34,12,6285,72,0.281304694,1768
Region IV-A (CALABARZON),PH040000000,Quezon,PH045600000,Guinayangan,PH045618000,10189,4502,1886,11,247,3445,34,0,8,19,10152,37,0.34535067,3506
Region IV-A (CALABARZON),PH040000000,Quezon,PH045600000,Gumaca,PH045619000,17334,9848,3724,167,279,2968,48,6,21,55,17116,218,0.180649685,3092
Region IV-A (CALABARZON),PH040000000,Quezon,PH045600000,Infanta,PH045620000,16209,10107,2374,51,519,2866,188,4,39,21,16169,40,0.19259076,3114
Region IV-A (CALABARZON),PH040000000,Quezon,PH045600000,Jomalig,PH045621000,1522,230,32,0,171,900,4,19,162,1,1519,3,0.702435813,1067
Region IV-A (CALABARZON),PH040000000,Quezon,PH045600000,Lopez,PH045622000,20674,10415,4744,54,271,4930,42,7,22,22,20507,167,0.244599405,5016
Region IV-A (CALABARZON),PH040000000,Quezon,PH045600000,Lucban,PH045623000,11342,9759,1296,9,25,230,3,0,2,9,11333,9,0.021530045,244
Region IV-A (CALABARZON),PH040000000,Quezon,PH045600000,City of Lucena (Capital),PH045624000,57743,44408,9973,417,141,1943,113,30,78,310,57413,330,0.042568756,2444
Region IV-A (CALABARZON),PH040000000,Quezon,PH045600000,Macalelon,PH045625000,5921,2266,1442,4,95,2093,2,0,6,4,5912,9,0.35605548,2105
Region IV-A (CALABARZON),PH040000000,Quezon,PH045600000,Mauban,PH045627000,14682,7397,3594,21,230,3291,20,3,5,11,14572,110,0.228314576,3327
Region IV-A (CALABARZON),PH040000000,Quezon,PH045600000,Mulanay,PH045628000,11589,4438,3985,107,93,2781,77,1,10,45,11537,52,0.252491982,2913
Region IV-A (CALABARZON),PH040000000,Quezon,PH045600000,Padre Burgos,PH045629000,5166,3208,1106,20,45,736,16,1,4,10,5146,20,0.148853478,766
Region IV-A (CALABARZON),PH040000000,Quezon,PH045600000,Pagbilao,PH045630000,17130,11877,3918,49,51,1110,10,12,26,24,17077,53,0.068513205,1170
Region IV-A (CALABARZON),PH040000000,Quezon,PH045600000,Panukulan,PH045631000,2890,883,183,1,200,1593,5,1,1,1,2868,22,0.557880056,1600
Region IV-A (CALABARZON),PH040000000,Quezon,PH045600000,Patnanungan,PH045632000,3279,940,334,0,126,1878,1,0,0,0,3279,0,0.573040561,1879
Region IV-A (CALABARZON),PH040000000,Quezon,PH045600000,Perez,PH045633000,2758,1265,637,9,123,705,9,1,2,1,2752,6,0.260537791,717
Region IV-A (CALABARZON),PH040000000,Quezon,PH045600000,Pitogo,PH045634000,5046,2162,1240,8,128,1481,6,0,4,10,5039,7,0.297876563,1501
Region IV-A (CALABARZON),PH040000000,Quezon,PH045600000,Plaridel,PH045635000,2249,1619,341,23,33,213,11,0,0,4,2244,5,0.101604278,228
Region IV-A (CALABARZON),PH040000000,Quezon,PH045600000,Polillo,PH045636000,6915,3001,777,19,454,2613,26,0,1,8,6899,16,0.383823743,2648
Region IV-A (CALABARZON),PH040000000,Quezon,PH045600000,Quezon,PH045637000,3654,1659,407,6,201,1356,7,0,2,3,3641,13,0.375720956,1368
Region IV-A (CALABARZON),PH040000000,Quezon,PH045600000,Real,PH045638000,7955,4435,1813,24,207,1357,41,5,17,40,7939,16,0.183272452,1455
Region IV-A (CALABARZON),PH040000000,Quezon,PH045600000,Sampaloc,PH045639000,2988,2295,473,2,42,171,2,0,1,0,2986,2,0.058271936,174
Region IV-A (CALABARZON),PH040000000,Quezon,PH045600000,San Andres,PH045640000,8643,2826,1558,5,232,3998,2,0,2,1,8624,19,0.464169759,4003
Region IV-A (CALABARZON),PH040000000,Quezon,PH045600000,San Antonio,PH045641000,7290,5777,1184,41,31,230,0,0,3,2,7268,22,0.032333517,235
Region IV-A (CALABARZON),PH040000000,Quezon,PH045600000,San Francisco (Aurora),PH045642000,13871,4172,3184,43,246,6060,83,1,11,57,13857,14,0.448221116,6211
Region IV-A (CALABARZON),PH040000000,Quezon,PH045600000,San Narciso,PH045644000,10638,3050,2674,19,226,4519,41,1,2,14,10546,92,0.433908591,4576
Region IV-A (CALABARZON),PH040000000,Quezon,PH045600000,Sariaya,PH045645000,34174,27012,5910,59,68,874,7,9,14,124,34077,97,0.029902867,1019
Region IV-A (CALABARZON),PH040000000,Quezon,PH045600000,Tagkawayan,PH045646000,11627,6904,2160,15,223,2266,11,3,7,17,11606,21,0.198259521,2301
Region IV-A (CALABARZON),PH040000000,Quezon,PH045600000,Tiaong,PH045648000,22287,17694,3962,159,17,251,15,8,16,56,22178,109,0.015240328,338
Region IV-A (CALABARZON),PH040000000,Quezon,PH045600000,Unisan,PH045649000,6172,3337,1142,7,119,1490,15,2,7,3,6122,50,0.247468148,1515
Region IV-A (CALABARZON),PH040000000,Rizal,PH045800000,Angono,PH045801000,24914,21328,3072,292,7,47,0,2,11,19,24778,136,0.003107595,77
Region IV-A (CALABARZON),PH040000000,Rizal,PH045800000,Baras,PH045803000,16186,14374,1480,15,105,100,2,0,6,4,16086,100,0.006962576,112
Region IV-A (CALABARZON),PH040000000,Rizal,PH045800000,Binangonan,PH045804000,66734,58359,6720,130,139,969,8,5,40,99,66469,265,0.016789782,1116
Region IV-A (CALABARZON),PH040000000,Rizal,PH045800000,Cainta,PH045805000,69983,62571,6941,28,14,140,7,51,71,91,69914,69,0.004419716,309
Region IV-A (CALABARZON),PH040000000,Rizal,PH045800000,Cardona,PH045806000,11089,8405,2264,26,36,285,3,0,3,3,11025,64,0.026666667,294
Region IV-A (CALABARZON),PH040000000,Rizal,PH045800000,City of Antipolo (Capital),PH045802000,169078,143297,21112,577,226,2161,49,104,367,557,168450,628,0.018604927,3134
Region IV-A (CALABARZON),PH040000000,Rizal,PH045800000,Jala-Jala,PH045807000,6836,5707,809,23,28,157,2,1,7,25,6759,77,0.028258618,191
Region IV-A (CALABARZON),PH040000000,Rizal,PH045800000,Morong,PH045809000,13057,10757,1597,35,48,474,17,5,26,17,12976,81,0.041152898,534
Region IV-A (CALABARZON),PH040000000,Rizal,PH045800000,Pililla,PH045810000,13854,10528,2304,113,95,552,7,9,27,30,13665,189,0.045078668,616
Region IV-A (CALABARZON),PH040000000,Rizal,PH045800000,Rodriguez (Montalban),PH045808000,81333,72486,6072,190,207,1662,146,29,97,153,81042,291,0.02539424,2058
Region IV-A (CALABARZON),PH040000000,Rizal,PH045800000,San Mateo,PH045811000,55563,48925,5548,142,60,467,20,31,99,127,55419,144,0.012865624,713
Region IV-A (CALABARZON),PH040000000,Rizal,PH045800000,Tanay,PH045812000,25463,17892,5656,120,57,1178,28,8,46,129,25114,349,0.054989249,1381
Region IV-A (CALABARZON),PH040000000,Rizal,PH045800000,Taytay,PH045813000,72439,58712,12339,487,52,267,9,11,108,125,72110,329,0.00705866,509
Region IV-A (CALABARZON),PH040000000,Rizal,PH045800000,Teresa,PH045814000,13411,11512,1588,97,15,111,6,2,8,28,13367,44,0.011446099,153
Mimaropa Region,PH170000000,Marinduque,PH174000000,Boac (Capital),PH174001000,12652,8452,2668,22,123,1305,14,4,6,10,12604,48,0.105918756,1335
Mimaropa Region,PH170000000,Marinduque,PH174000000,Buenavista,PH174002000,5309,2993,1105,2,69,1131,1,0,3,1,5305,4,0.214137606,1136
Mimaropa Region,PH170000000,Marinduque,PH174000000,Gasan,PH174003000,7997,5097,1549,8,67,1244,7,0,1,3,7976,21,0.157347041,1255
Mimaropa Region,PH170000000,Marinduque,PH174000000,Mogpog,PH174004000,8219,5600,1759,15,52,742,11,0,20,7,8206,13,0.095052401,780
Mimaropa Region,PH170000000,Marinduque,PH174000000,Santa Cruz,PH174005000,13309,8527,3492,43,46,1082,20,0,19,15,13244,65,0.08577469,1136
Mimaropa Region,PH170000000,Marinduque,PH174000000,Torrijos,PH174006000,6855,4307,1457,5,41,1037,1,1,1,2,6852,3,0.151926445,1041
Mimaropa Region,PH170000000,Occidental Mindoro,PH175100000,Abra De Ilog,PH175101000,7185,3313,590,7,182,3010,72,0,2,6,7182,3,0.430242272,3090
Mimaropa Region,PH170000000,Occidental Mindoro,PH175100000,Calintaan,PH175102000,6430,2961,1247,4,130,1904,16,0,4,7,6273,157,0.307827196,1931
Mimaropa Region,PH170000000,Occidental Mindoro,PH175100000,Looc,PH175103000,2295,1427,99,0,163,597,1,2,0,2,2291,4,0.261894369,600
Mimaropa Region,PH170000000,Occidental Mindoro,PH175100000,Lubang,PH175104000,4642,3331,268,3,333,693,2,3,1,3,4637,5,0.150744016,699
Mimaropa Region,PH170000000,Occidental Mindoro,PH175100000,Magsaysay,PH175105000,7782,3001,2199,3,45,2486,6,0,0,4,7744,38,0.32231405,2496
Mimaropa Region,PH170000000,Occidental Mindoro,PH175100000,Mamburao (Capital),PH175106000,9912,6465,1479,12,202,1683,16,0,2,15,9874,38,0.173789751,1716
Mimaropa Region,PH170000000,Occidental Mindoro,PH175100000,Paluan,PH175107000,3481,1320,530,1,123,1496,4,1,3,0,3478,3,0.432144911,1503
Mimaropa Region,PH170000000,Occidental Mindoro,PH175100000,Rizal,PH175108000,8426,4127,1978,2,89,2167,1,1,3,0,8368,58,0.259440727,2171
Mimaropa Region,PH170000000,Occidental Mindoro,PH175100000,Sablayan,PH175109000,18473,9541,3324,12,248,5243,7,1,6,2,18384,89,0.286009574,5258
Mimaropa Region,PH170000000,Occidental Mindoro,PH175100000,San Jose,PH175110000,32761,18985,6513,32,228,6746,12,4,20,19,32559,202,0.208759483,6797
Mimaropa Region,PH170000000,Occidental Mindoro,PH175100000,Santa Cruz,PH175111000,8888,4035,765,0,700,3262,82,0,0,1,8845,43,0.378179763,3345
Mimaropa Region,PH170000000,Oriental Mindoro,PH175200000,Baco,PH175201000,8248,4799,1065,6,246,2038,6,4,15,18,8197,51,0.253385385,2077
Mimaropa Region,PH170000000,Oriental Mindoro,PH175200000,Bansud,PH175202000,9144,5180,1975,19,112,1808,12,2,5,8,9121,23,0.200964806,1833
Mimaropa Region,PH170000000,Oriental Mindoro,PH175200000,Bongabong,PH175203000,16450,8278,2741,18,280,5022,43,0,3,21,16406,44,0.310191393,5089
Mimaropa Region,PH170000000,Oriental Mindoro,PH175200000,Bulalacao (San Pedro),PH175204000,8485,1878,1119,10,154,5245,3,0,7,24,8440,45,0.625473934,5279
Mimaropa Region,PH170000000,Oriental Mindoro,PH175200000,City of Calapan (Capital),PH175205000,30324,23437,2914,28,761,3069,36,4,13,22,30284,40,0.103685114,3140
Mimaropa Region,PH170000000,Oriental Mindoro,PH175200000,Gloria,PH175206000,10314,6139,1893,15,208,2025,10,0,4,3,10297,17,0.198310187,2042
Mimaropa Region,PH170000000,Oriental Mindoro,PH175200000,Mansalay,PH175207000,11219,3910,886,9,268,6063,6,7,12,18,11179,40,0.545576527,6099
Mimaropa Region,PH170000000,Oriental Mindoro,PH175200000,Naujan,PH175208000,23221,14892,2499,53,907,4670,23,7,32,36,23119,102,0.205934513,4761
Mimaropa Region,PH170000000,Oriental Mindoro,PH175200000,Pinamalayan,PH175209000,19281,12937,3279,74,337,2354,154,7,14,47,19203,78,0.13378118,2569
Mimaropa Region,PH170000000,Oriental Mindoro,PH175200000,Pola,PH175210000,8169,4316,1221,6,320,2235,9,1,8,5,8121,48,0.277921438,2257
Mimaropa Region,PH170000000,Oriental Mindoro,PH175200000,Puerto Galera,PH175211000,8292,5307,1302,44,133,1287,78,4,8,98,8261,31,0.178065609,1471
Mimaropa Region,PH170000000,Oriental Mindoro,PH175200000,Roxas,PH175212000,11628,7009,1864,42,162,2440,20,2,15,11,11565,63,0.214958928,2486
Mimaropa Region,PH170000000,Oriental Mindoro,PH175200000,San Teodoro,PH175213000,4039,2216,512,10,130,1150,7,1,0,1,4027,12,0.287558977,1158
Mimaropa Region,PH170000000,Oriental Mindoro,PH175200000,Socorro,PH175214000,9054,5703,1985,10,107,1188,2,0,22,6,9023,31,0.134988363,1218
Mimaropa Region,PH170000000,Oriental Mindoro,PH175200000,Victoria,PH175215000,11120,7351,1535,27,207,1934,3,0,5,3,11065,55,0.175779485,1945
Mimaropa Region,PH170000000,Palawan,PH175300000,Aborlan,PH175301000,8267,2989,1781,16,89,3334,2,3,8,7,8229,38,0.407218374,3351
Mimaropa Region,PH170000000,Palawan,PH175300000,Agutaya,PH175302000,3044,1097,990,2,25,924,0,0,1,0,3039,5,0.30437644,925
Mimaropa Region,PH170000000,Palawan,PH175300000,Araceli,PH175303000,3206,788,749,1,46,1608,0,1,5,1,3199,7,0.504532666,1614
Mimaropa Region,PH170000000,Palawan,PH175300000,Balabac,PH175304000,8411,222,3548,0,37,4587,3,0,2,0,8399,12,0.546731754,4592
Mimaropa Region,PH170000000,Palawan,PH175300000,Bataraza,PH175305000,17923,4130,3452,3,148,9970,19,0,8,2,17732,191,0.563895782,9999
Mimaropa Region,PH170000000,Palawan,PH175300000,Brooke'S Point,PH175306000,15383,4336,3619,25,161,7149,5,3,9,6,15313,70,0.468164305,7169
Mimaropa Region,PH170000000,Palawan,PH175300000,Busuanga,PH175307000,5032,1134,1175,9,89,2568,8,0,6,6,4995,37,0.518118118,2588
Mimaropa Region,PH170000000,Palawan,PH175300000,Cagayancillo,PH175308000,1100,480,346,0,6,266,0,0,0,0,1098,2,0.242258652,266
Mimaropa Region,PH170000000,Palawan,PH175300000,Coron,PH175309000,11463,3052,4985,31,58,3169,8,1,5,9,11318,145,0.281940272,3191
Mimaropa Region,PH170000000,Palawan,PH175300000,Culion,PH175322000,4640,1025,1627,5,14,1912,4,1,5,9,4602,38,0.419382877,1930
Mimaropa Region,PH170000000,Palawan,PH175300000,Cuyo,PH175310000,5015,2961,568,1,93,1376,4,0,1,3,5007,8,0.276413022,1384
Mimaropa Region,PH170000000,Palawan,PH175300000,Dumaran,PH175311000,5757,1263,756,0,67,3614,2,0,1,1,5704,53,0.634291725,3618
Mimaropa Region,PH170000000,Palawan,PH175300000,El Nido (Bacuit),PH175312000,9465,2966,2756,4,48,3595,5,0,2,0,9376,89,0.384172355,3602
Mimaropa Region,PH170000000,Palawan,PH175300000,Kalayaan,PH175321000,31,7,24,0,0,0,0,0,0,0,31,0,0,0
Mimaropa Region,PH170000000,Palawan,PH175300000,Linapacan,PH175313000,3359,453,900,0,17,1968,1,0,0,0,3339,20,0.589697514,1969
Mimaropa Region,PH170000000,Palawan,PH175300000,Magsaysay,PH175314000,2731,1553,321,0,40,813,1,0,1,2,2731,0,0.299157818,817
Mimaropa Region,PH170000000,Palawan,PH175300000,Narra,PH175315000,16897,6257,5375,5,126,4990,5,1,14,0,16773,124,0.298634711,5009
Mimaropa Region,PH170000000,Palawan,PH175300000,City of Puerto Princesa (Capital),PH175316000,61665,29335,19522,53,380,11071,61,3,34,32,60491,1174,0.185118447,11198
Mimaropa Region,PH170000000,Palawan,PH175300000,Quezon,PH175317000,13912,2411,3106,1,74,8186,6,0,7,0,13791,121,0.594518164,8199
Mimaropa Region,PH170000000,Palawan,PH175300000,Rizal (Marcos),PH175323000,12731,1580,1264,1,147,9663,8,0,1,0,12664,67,0.763739735,9672
Mimaropa Region,PH170000000,Palawan,PH175300000,Roxas,PH175318000,15321,4199,2608,3,265,8165,18,1,7,4,15270,51,0.536607728,8194
Mimaropa Region,PH170000000,Palawan,PH175300000,San Vicente,PH175319000,6707,2058,1481,10,98,2998,26,0,1,1,6673,34,0.453469204,3026
Mimaropa Region,PH170000000,Palawan,PH175300000,Sofronio Española,PH175324000,7673,1424,1658,1,62,4494,4,2,0,0,7645,28,0.588358404,4498
Mimaropa Region,PH170000000,Palawan,PH175300000,Taytay,PH175320000,15993,3750,3773,6,182,8033,7,0,4,7,15762,231,0.510785433,8051
Mimaropa Region,PH170000000,Romblon,PH175900000,Alcantara,PH175901000,3666,1956,313,15,170,1100,16,9,26,48,3653,13,0.32575965,1190
Mimaropa Region,PH170000000,Romblon,PH175900000,Banton,PH175902000,1419,897,233,0,55,230,0,0,0,3,1418,1,0.164315938,233
Mimaropa Region,PH170000000,Romblon,PH175900000,Cajidiocan,PH175903000,4951,2289,782,0,126,1729,16,0,4,4,4950,1,0.354141414,1753
Mimaropa Region,PH170000000,Romblon,PH175900000,Calatrava,PH175904000,2299,1062,322,3,75,828,1,0,3,1,2295,4,0.362962963,833
Mimaropa Region,PH170000000,Romblon,PH175900000,Concepcion,PH175905000,1047,478,361,0,13,195,0,0,0,0,1047,0,0.186246418,195
Mimaropa Region,PH170000000,Romblon,PH175900000,Corcuera,PH175906000,2467,748,45,0,410,1251,1,1,1,10,2467,0,0.511957844,1263
Mimaropa Region,PH170000000,Romblon,PH175900000,Ferrol,PH175916000,1653,694,388,0,35,531,3,0,0,0,1651,2,0.323440339,534
Mimaropa Region,PH170000000,Romblon,PH175900000,Looc,PH175907000,5363,3013,985,5,106,1174,4,1,0,1,5289,74,0.222915485,1179
Mimaropa Region,PH170000000,Romblon,PH175900000,Magdiwang,PH175908000,3066,1281,559,3,97,1072,13,8,21,7,3061,5,0.363606664,1113
Mimaropa Region,PH170000000,Romblon,PH175900000,Odiongan,PH175909000,11388,6508,3246,2,86,1521,2,0,0,0,11365,23,0.134007919,1523
Mimaropa Region,PH170000000,Romblon,PH175900000,Romblon (Capital),PH175910000,8910,5080,1198,15,401,2158,20,5,6,3,8886,24,0.246117488,2187
Mimaropa Region,PH170000000,Romblon,PH175900000,San Agustin,PH175911000,5258,2960,561,9,204,1462,18,2,5,30,5251,7,0.288516473,1515
Mimaropa Region,PH170000000,Romblon,PH175900000,San Andres,PH175912000,3544,2053,416,4,80,984,0,0,0,0,3537,7,0.278201866,984
Mimaropa Region,PH170000000,Romblon,PH175900000,San Fernando,PH175913000,4978,2119,929,0,191,1684,7,9,27,4,4970,8,0.346478873,1722
Mimaropa Region,PH170000000,Romblon,PH175900000,San Jose,PH175914000,2391,964,306,0,182,933,3,0,0,1,2389,2,0.392214316,937
Mimaropa Region,PH170000000,Romblon,PH175900000,Santa Fe,PH175915000,3691,1458,144,0,299,1774,1,0,0,0,3676,15,0.482861806,1775
Mimaropa Region,PH170000000,Romblon,PH175900000,Santa Maria (Imelda),PH175917000,1880,847,262,8,52,657,19,9,7,19,1880,0,0.373404255,702
Region IX (Zamboanga Peninsula),PH090000000,City of Isabela (Not a Province),PH099700000,City of Isabela,PH099701000,20127,8085,8158,11,72,3732,14,0,5,2,20079,48,0.186911699,3753
Region IX (Zamboanga Peninsula),PH090000000,Zamboanga Del Norte,PH097200000,Bacungan (Leon T. Postigo),PH097226000,5552,1177,2308,6,54,1927,2,0,1,0,5475,77,0.352511416,1930
Region IX (Zamboanga Peninsula),PH090000000,Zamboanga Del Norte,PH097200000,Baliguian,PH097224000,5172,729,768,0,110,3565,0,0,0,0,5172,0,0.689288476,3565
Region IX (Zamboanga Peninsula),PH090000000,Zamboanga Del Norte,PH097200000,City of Dapitan,PH097201000,17953,5817,7258,53,123,4504,63,0,20,27,17865,88,0.258270361,4614
Region IX (Zamboanga Peninsula),PH090000000,Zamboanga Del Norte,PH097200000,City of Dipolog (Capital),PH097202000,29503,13596,9082,24,256,6287,27,2,9,52,29335,168,0.217317198,6375
Region IX (Zamboanga Peninsula),PH090000000,Zamboanga Del Norte,PH097200000,Godod,PH097225000,3791,335,2514,1,0,921,1,0,0,2,3774,17,0.244833068,924
Region IX (Zamboanga Peninsula),PH090000000,Zamboanga Del Norte,PH097200000,Gutalac,PH097223000,7562,1430,1649,0,171,4293,3,1,1,0,7548,14,0.569289878,4297
Region IX (Zamboanga Peninsula),PH090000000,Zamboanga Del Norte,PH097200000,Jose Dalman (Ponot),PH097222000,6103,1014,2626,3,83,2359,1,0,1,0,6087,16,0.387875801,2361
Region IX (Zamboanga Peninsula),PH090000000,Zamboanga Del Norte,PH097200000,Kalawit,PH097227000,4821,1218,1740,3,36,1818,1,0,2,0,4818,3,0.377957659,1821
Region IX (Zamboanga Peninsula),PH090000000,Zamboanga Del Norte,PH097200000,Katipunan,PH097203000,9718,2126,3138,2,133,4268,11,1,0,8,9687,31,0.442551874,4287
Region IX (Zamboanga Peninsula),PH090000000,Zamboanga Del Norte,PH097200000,La Libertad,PH097204000,1868,602,889,1,6,361,0,0,0,0,1859,9,0.194190425,361
Region IX (Zamboanga Peninsula),PH090000000,Zamboanga Del Norte,PH097200000,Labason,PH097205000,9050,2690,1962,2,232,4140,9,0,2,4,9041,9,0.459573056,4155
Region IX (Zamboanga Peninsula),PH090000000,Zamboanga Del Norte,PH097200000,Liloy,PH097206000,9344,3483,2892,3,280,2600,3,0,3,11,9275,69,0.282156334,2617
Region IX (Zamboanga Peninsula),PH090000000,Zamboanga Del Norte,PH097200000,Manukan,PH097207000,7771,2082,2739,6,214,2645,12,0,9,4,7711,60,0.346258592,2670
Region IX (Zamboanga Peninsula),PH090000000,Zamboanga Del Norte,PH097200000,Mutia,PH097208000,2683,671,1621,6,12,361,2,0,3,3,2679,4,0.137737962,369
Region IX (Zamboanga Peninsula),PH090000000,Zamboanga Del Norte,PH097200000,Piñan (New Piñan),PH097209000,4609,1235,2154,5,24,1160,3,0,1,1,4583,26,0.254200305,1165
Region IX (Zamboanga Peninsula),PH090000000,Zamboanga Del Norte,PH097200000,Polanco,PH097210000,9109,3294,3395,4,64,2324,0,1,7,0,9089,20,0.256463857,2331
Region IX (Zamboanga Peninsula),PH090000000,Zamboanga Del Norte,PH097200000,Pres. Manuel A. Roxas,PH097211000,8319,1761,2591,8,167,3717,12,1,18,4,8279,40,0.453074043,3751
Region IX (Zamboanga Peninsula),PH090000000,Zamboanga Del Norte,PH097200000,Rizal,PH097212000,3501,1039,1407,3,13,1026,2,0,1,0,3491,10,0.294757949,1029
Region IX (Zamboanga Peninsula),PH090000000,Zamboanga Del Norte,PH097200000,Salug,PH097213000,7225,1741,2978,2,165,2288,1,0,0,1,7176,49,0.319119287,2290
Region IX (Zamboanga Peninsula),PH090000000,Zamboanga Del Norte,PH097200000,Sergio Osmeña Sr.,PH097214000,6513,1110,3725,0,13,1539,0,0,0,0,6387,126,0.240958196,1539
Region IX (Zamboanga Peninsula),PH090000000,Zamboanga Del Norte,PH097200000,Siayan,PH097215000,7253,662,2230,2,35,4293,4,0,0,6,7232,21,0.594994469,4303
Region IX (Zamboanga Peninsula),PH090000000,Zamboanga Del Norte,PH097200000,Sibuco,PH097216000,7222,1456,1471,1,66,4113,55,3,9,33,7207,15,0.584154294,4210
Region IX (Zamboanga Peninsula),PH090000000,Zamboanga Del Norte,PH097200000,Sibutad,PH097217000,4308,1037,1628,5,30,1595,2,0,1,0,4298,10,0.371800838,1598
Region IX (Zamboanga Peninsula),PH090000000,Zamboanga Del Norte,PH097200000,Sindangan,PH097218000,22155,6562,8303,49,143,6815,67,6,86,12,22043,112,0.316653813,6980
Region IX (Zamboanga Peninsula),PH090000000,Zamboanga Del Norte,PH097200000,Siocon,PH097219000,10608,2259,2035,0,133,6154,3,0,0,0,10584,24,0.581727135,6157
Region IX (Zamboanga Peninsula),PH090000000,Zamboanga Del Norte,PH097200000,Sirawai,PH097220000,5854,903,1093,0,64,3721,0,0,0,0,5781,73,0.643660266,3721
Region IX (Zamboanga Peninsula),PH090000000,Zamboanga Del Norte,PH097200000,Tampilisan,PH097221000,5654,1598,2444,3,18,1524,2,0,45,13,5647,7,0.280502922,1584
Region IX (Zamboanga Peninsula),PH090000000,Zamboanga Del Sur,PH097300000,Aurora,PH097302000,10980,4094,3859,8,56,2935,9,0,5,7,10973,7,0.269388499,2956
Region IX (Zamboanga Peninsula),PH090000000,Zamboanga Del Sur,PH097300000,Bayog,PH097303000,6908,1665,3648,0,12,1575,1,0,1,0,6902,6,0.228484497,1577
Region IX (Zamboanga Peninsula),PH090000000,Zamboanga Del Sur,PH097300000,Dimataling,PH097305000,6501,1344,2469,16,26,2546,35,0,1,44,6481,20,0.405184385,2626
Region IX (Zamboanga Peninsula),PH090000000,Zamboanga Del Sur,PH097300000,Dinas,PH097306000,7679,1580,3424,2,32,2618,1,1,4,1,7663,16,0.342424638,2624
Region IX (Zamboanga Peninsula),PH090000000,Zamboanga Del Sur,PH097300000,Dumalinao,PH097307000,7064,1741,3985,2,37,1274,0,0,0,1,7040,24,0.181107955,1275
Region IX (Zamboanga Peninsula),PH090000000,Zamboanga Del Sur,PH097300000,Dumingag,PH097308000,9817,2702,3113,3,60,3910,6,0,3,3,9800,17,0.400204082,3922
Region IX (Zamboanga Peninsula),PH090000000,Zamboanga Del Sur,PH097300000,Guipos,PH097343000,4302,1301,2413,0,7,577,0,0,0,0,4298,4,0.134248488,577
Region IX (Zamboanga Peninsula),PH090000000,Zamboanga Del Sur,PH097300000,Josefina,PH097337000,2499,695,1539,1,4,260,0,0,0,0,2499,0,0.104041617,260
Region IX (Zamboanga Peninsula),PH090000000,Zamboanga Del Sur,PH097300000,Kumalarang,PH097311000,5923,1144,1539,0,55,3139,0,0,0,0,5877,46,0.534116046,3139
Region IX (Zamboanga Peninsula),PH090000000,Zamboanga Del Sur,PH097300000,Labangan,PH097312000,8428,3443,2681,3,58,2213,4,1,10,4,8417,11,0.26505881,2231
Region IX (Zamboanga Peninsula),PH090000000,Zamboanga Del Sur,PH097300000,Lakewood,PH097333000,4094,907,1951,0,14,1197,0,0,1,0,4070,24,0.294348894,1198
Region IX (Zamboanga Peninsula),PH090000000,Zamboanga Del Sur,PH097300000,Lapuyan,PH097313000,5215,813,1406,0,27,2958,2,0,2,0,5208,7,0.568740399,2962
Region IX (Zamboanga Peninsula),PH090000000,Zamboanga Del Sur,PH097300000,Mahayag,PH097315000,9718,3825,3129,0,40,2713,0,0,1,0,9708,10,0.279563247,2714
Region IX (Zamboanga Peninsula),PH090000000,Zamboanga Del Sur,PH097300000,Margosatubig,PH097317000,8794,2081,4544,2,42,2086,1,0,3,3,8762,32,0.238872404,2093
Region IX (Zamboanga Peninsula),PH090000000,Zamboanga Del Sur,PH097300000,Midsalip,PH097318000,6774,1492,2380,2,11,2862,4,2,9,3,6765,9,0.425424982,2878
Region IX (Zamboanga Peninsula),PH090000000,Zamboanga Del Sur,PH097300000,Molave,PH097319000,11401,4579,3710,8,92,2971,6,0,13,15,11394,7,0.263735299,3005
Region IX (Zamboanga Peninsula),PH090000000,Zamboanga Del Sur,PH097300000,City of Pagadian (Capital),PH097322000,40665,16310,17363,11,114,6724,4,23,24,19,40592,73,0.166806267,6771
Region IX (Zamboanga Peninsula),PH090000000,Zamboanga Del Sur,PH097300000,Pitogo,PH097338000,5853,1481,2730,29,38,1509,13,0,33,11,5844,9,0.267967146,1566
Region IX (Zamboanga Peninsula),PH090000000,Zamboanga Del Sur,PH097300000,Ramon Magsaysay (Liargo),PH097323000,5968,1874,2828,1,19,1220,2,0,1,0,5945,23,0.205719092,1223
Region IX (Zamboanga Peninsula),PH090000000,Zamboanga Del Sur,PH097300000,San Miguel,PH097324000,4205,828,2610,0,6,754,0,0,0,0,4198,7,0.179609338,754
Region IX (Zamboanga Peninsula),PH090000000,Zamboanga Del Sur,PH097300000,San Pablo,PH097325000,5792,1127,3535,0,16,1103,0,0,0,0,5781,11,0.19079744,1103
Region IX (Zamboanga Peninsula),PH090000000,Zamboanga Del Sur,PH097300000,Sominot (Don Mariano Marcos),PH097340000,4144,932,2191,2,13,991,0,0,0,1,4130,14,0.240193705,992
Region IX (Zamboanga Peninsula),PH090000000,Zamboanga Del Sur,PH097300000,Tabina,PH097327000,5613,1675,2661,2,13,1243,0,1,5,1,5601,12,0.222995894,1249
Region IX (Zamboanga Peninsula),PH090000000,Zamboanga Del Sur,PH097300000,Tambulig,PH097328000,7686,2079,2937,5,49,2547,10,0,8,6,7641,45,0.336474283,2571
Region IX (Zamboanga Peninsula),PH090000000,Zamboanga Del Sur,PH097300000,Tigbao,PH097344000,4591,970,2585,0,12,1019,0,0,0,0,4586,5,0.222197994,1019
Region IX (Zamboanga Peninsula),PH090000000,Zamboanga Del Sur,PH097300000,Tukuran,PH097330000,8465,2365,4050,5,31,1995,5,0,2,1,8454,11,0.236929264,2003
Region IX (Zamboanga Peninsula),PH090000000,Zamboanga Del Sur,PH097300000,Vincenzo A. Sagun,PH097341000,4898,1070,2283,2,14,1519,3,0,0,0,4891,7,0.311183807,1522
Region IX (Zamboanga Peninsula),PH090000000,Zamboanga Del Sur,PH097300000,City of Zamboanga,PH097332000,185621,78378,70842,232,813,32792,139,48,295,496,184035,1586,0.183236884,33722
Region IX (Zamboanga Peninsula),PH090000000,Zamboanga Sibugay,PH098300000,Alicia,PH098301000,7630,962,2050,1,54,4543,4,0,2,3,7619,11,0.597453734,4552
Region IX (Zamboanga Peninsula),PH090000000,Zamboanga Sibugay,PH098300000,Buug,PH098302000,8116,2625,3739,0,31,1671,0,0,0,0,8066,50,0.207165881,1671
Region IX (Zamboanga Peninsula),PH090000000,Zamboanga Sibugay,PH098300000,Diplahan,PH098303000,7605,2270,3408,15,39,1795,4,19,7,10,7567,38,0.239989428,1816
Region IX (Zamboanga Peninsula),PH090000000,Zamboanga Sibugay,PH098300000,Imelda,PH098304000,6507,1535,2508,2,27,2354,13,0,8,4,6451,56,0.368780034,2379
Region IX (Zamboanga Peninsula),PH090000000,Zamboanga Sibugay,PH098300000,Ipil (Capital),PH098305000,17616,5653,4729,6,184,6964,13,2,7,5,17563,53,0.397938849,6989
Region IX (Zamboanga Peninsula),PH090000000,Zamboanga Sibugay,PH098300000,Kabasalan,PH098306000,9473,2324,2127,3,249,4716,20,0,4,5,9448,25,0.502222693,4745
Region IX (Zamboanga Peninsula),PH090000000,Zamboanga Sibugay,PH098300000,Mabuhay,PH098307000,6783,424,1440,1,92,4811,1,0,1,0,6770,13,0.710930576,4813
Region IX (Zamboanga Peninsula),PH090000000,Zamboanga Sibugay,PH098300000,Malangas,PH098308000,7962,2288,2168,1,65,3185,1,1,1,1,7711,251,0.413435352,3188
Region IX (Zamboanga Peninsula),PH090000000,Zamboanga Sibugay,PH098300000,Naga,PH098309000,8433,1983,3029,0,79,3320,7,0,1,3,8422,11,0.395511755,3331
Region IX (Zamboanga Peninsula),PH090000000,Zamboanga Sibugay,PH098300000,Olutanga,PH098310000,6523,871,1825,2,55,3707,34,0,0,0,6494,29,0.576070219,3741
Region IX (Zamboanga Peninsula),PH090000000,Zamboanga Sibugay,PH098300000,Payao,PH098311000,6921,951,1704,2,94,4145,4,1,3,3,6907,14,0.601563631,4155
Region IX (Zamboanga Peninsula),PH090000000,Zamboanga Sibugay,PH098300000,Roseller Lim,PH098312000,10443,1692,4466,1,41,4162,2,0,2,1,10367,76,0.40194849,4167
Region IX (Zamboanga Peninsula),PH090000000,Zamboanga Sibugay,PH098300000,Siay,PH098313000,9128,1702,2781,4,116,4436,6,3,16,4,9068,60,0.492059991,4462
Region IX (Zamboanga Peninsula),PH090000000,Zamboanga Sibugay,PH098300000,Talusan,PH098314000,5101,520,1198,0,49,3321,0,0,3,0,5091,10,0.652916912,3324
Region IX (Zamboanga Peninsula),PH090000000,Zamboanga Sibugay,PH098300000,Titay,PH098315000,11087,3425,3744,6,69,3753,9,2,15,4,11027,60,0.342885644,3781
Region IX (Zamboanga Peninsula),PH090000000,Zamboanga Sibugay,PH098300000,Tungawan,PH098316000,9418,1879,2352,2,107,5024,3,3,1,4,9375,43,0.536746667,5032
Region V (Bicol Region),PH050000000,Albay,PH050500000,Bacacay,PH050501000,14348,7912,813,4,1957,3648,10,0,1,1,14346,2,0.255123379,3660
Region V (Bicol Region),PH050000000,Albay,PH050500000,Camalig,PH050502000,14763,9726,820,12,1378,2765,23,3,15,12,14754,9,0.190795716,2815
Region V (Bicol Region),PH050000000,Albay,PH050500000,City of Ligao,PH050508000,22491,13305,1562,19,1660,5834,26,13,41,16,22476,15,0.263258587,5917
Region V (Bicol Region),PH050000000,Albay,PH050500000,City of Tabaco,PH050517000,27533,19345,1920,85,1574,3800,124,131,74,149,27202,331,0.152452026,4147
Region V (Bicol Region),PH050000000,Albay,PH050500000,Daraga (Locsin),PH050503000,27551,21312,1638,65,1293,3104,57,12,26,33,27540,11,0.116920842,3220
Region V (Bicol Region),PH050000000,Albay,PH050500000,Guinobatan,PH050504000,17882,11085,1120,22,1434,4106,31,6,28,34,17866,16,0.235027426,4199
Region V (Bicol Region),PH050000000,Albay,PH050500000,Jovellar,PH050505000,3811,1255,320,4,343,1874,13,0,0,0,3809,2,0.495405618,1887
Region V (Bicol Region),PH050000000,Albay,PH050500000,City of Legazpi (Capital),PH050506000,41437,31319,3336,145,1952,4254,108,85,87,107,41393,44,0.11006692,4556
Region V (Bicol Region),PH050000000,Albay,PH050500000,Libon,PH050507000,15461,6654,1934,9,1099,5692,9,16,19,11,15443,18,0.37110665,5731
Region V (Bicol Region),PH050000000,Albay,PH050500000,Malilipot,PH050509000,8059,5471,462,27,724,1310,26,8,10,11,8049,10,0.168592372,1357
Region V (Bicol Region),PH050000000,Albay,PH050500000,Malinao,PH050510000,9748,6284,637,3,485,2289,10,4,9,12,9733,15,0.238364328,2320
Region V (Bicol Region),PH050000000,Albay,PH050500000,Manito,PH050511000,5056,2551,385,11,613,1318,46,12,77,40,5053,3,0.293093212,1481
Region V (Bicol Region),PH050000000,Albay,PH050500000,Oas,PH050512000,14036,6528,1403,20,1089,4875,65,6,7,32,14025,11,0.355008913,4979
Region V (Bicol Region),PH050000000,Albay,PH050500000,Pio Duran,PH050513000,9452,3520,525,0,1069,4316,8,0,3,5,9446,6,0.458606818,4332
Region V (Bicol Region),PH050000000,Albay,PH050500000,Polangui,PH050514000,18188,10871,2128,14,728,4294,18,4,21,18,18096,92,0.240439876,4351
Region V (Bicol Region),PH050000000,Albay,PH050500000,Rapu-Rapu,PH050515000,7395,2393,383,5,1243,3316,30,3,9,11,7393,2,0.45529555,3366
Region V (Bicol Region),PH050000000,Albay,PH050500000,Santo Domingo (Libog),PH050516000,7415,4474,176,2,1371,1345,33,5,3,3,7412,3,0.186724231,1384
Region V (Bicol Region),PH050000000,Albay,PH050500000,Tiwi,PH050518000,10975,7121,988,4,527,2288,6,2,7,24,10967,8,0.211999635,2325
Region V (Bicol Region),PH050000000,Camarines Norte,PH051600000,Basud,PH051601000,9078,4854,782,9,738,2635,22,1,2,2,9045,33,0.294195688,2661
Region V (Bicol Region),PH050000000,Camarines Norte,PH051600000,Capalonga,PH051602000,7091,2217,584,0,606,3661,7,0,2,6,7083,8,0.518989129,3676
Region V (Bicol Region),PH050000000,Camarines Norte,PH051600000,Daet (Capital),PH051603000,22803,17481,1395,19,1147,2639,34,5,16,11,22747,56,0.118696971,2700
Region V (Bicol Region),PH050000000,Camarines Norte,PH051600000,Jose Panganiban,PH051605000,13381,6733,2165,22,657,3698,46,2,7,25,13355,26,0.282740547,3776
Region V (Bicol Region),PH050000000,Camarines Norte,PH051600000,Labo,PH051606000,22201,11118,2878,13,1373,6690,22,2,8,15,22119,82,0.304489353,6735
Region V (Bicol Region),PH050000000,Camarines Norte,PH051600000,Mercedes,PH051607000,10866,4668,819,0,1459,3856,14,1,21,6,10844,22,0.359369236,3897
Region V (Bicol Region),PH050000000,Camarines Norte,PH051600000,Paracale,PH051608000,13096,6470,1374,9,1203,3979,21,3,12,7,13078,18,0.307309986,4019
Region V (Bicol Region),PH050000000,Camarines Norte,PH051600000,San Lorenzo Ruiz (Imelda),PH051604000,3154,1539,489,0,128,984,2,0,8,3,3153,1,0.316206787,997
Region V (Bicol Region),PH050000000,Camarines Norte,PH051600000,San Vicente,PH051609000,2394,1504,133,1,113,635,1,4,1,0,2392,2,0.266304348,637
Region V (Bicol Region),PH050000000,Camarines Norte,PH051600000,Santa Elena,PH051610000,9182,4520,1190,13,523,2743,29,7,11,3,9039,143,0.308219936,2786
Region V (Bicol Region),PH050000000,Camarines Norte,PH051600000,Talisay,PH051611000,5801,3926,260,0,398,1194,2,0,3,2,5785,16,0.207605877,1201
Region V (Bicol Region),PH050000000,Camarines Norte,PH051600000,Vinzons,PH051612000,9632,4568,351,3,1175,3486,27,1,3,10,9624,8,0.366375727,3526
Region V (Bicol Region),PH050000000,Camarines Sur,PH051700000,Baao,PH051701000,11390,7018,1424,21,354,2489,19,2,6,24,11357,33,0.223474509,2538
Region V (Bicol Region),PH050000000,Camarines Sur,PH051700000,Balatan,PH051702000,5801,1764,369,4,1174,2411,16,2,2,4,5746,55,0.423424991,2433
Region V (Bicol Region),PH050000000,Camarines Sur,PH051700000,Bato,PH051703000,9720,4114,685,1,926,3970,4,2,0,1,9703,17,0.409667113,3975
Region V (Bicol Region),PH050000000,Camarines Sur,PH051700000,Bombon,PH051704000,3441,1861,363,1,175,1000,3,1,1,0,3405,36,0.294860499,1004
Region V (Bicol Region),PH050000000,Camarines Sur,PH051700000,Buhi,PH051705000,16266,8565,2122,11,403,5028,31,3,4,22,16189,77,0.314102168,5085
Region V (Bicol Region),PH050000000,Camarines Sur,PH051700000,Bula,PH051706000,13482,5832,1224,12,841,5474,27,1,2,6,13419,63,0.410537298,5509
Region V (Bicol Region),PH050000000,Camarines Sur,PH051700000,Cabusao,PH051707000,3897,1908,456,11,217,1274,9,1,0,9,3885,12,0.332561133,1292
Region V (Bicol Region),PH050000000,Camarines Sur,PH051700000,Calabanga,PH051708000,17035,8771,1341,12,808,6018,15,6,17,11,16999,36,0.356550385,6061
Region V (Bicol Region),PH050000000,Camarines Sur,PH051700000,Camaligan,PH051709000,4737,2914,1084,9,116,570,10,6,1,3,4713,24,0.123912582,584
Region V (Bicol Region),PH050000000,Camarines Sur,PH051700000,Canaman,PH051710000,6968,4035,585,20,298,1966,29,1,8,7,6949,19,0.289250252,2010
Region V (Bicol Region),PH050000000,Camarines Sur,PH051700000,Caramoan,PH051711000,9878,3590,1256,6,421,4576,10,0,5,10,9874,4,0.465971238,4601
Region V (Bicol Region),PH050000000,Camarines Sur,PH051700000,Del Gallego,PH051712000,5243,2700,903,2,223,1331,12,1,0,0,5172,71,0.25966744,1343
Region V (Bicol Region),PH050000000,Camarines Sur,PH051700000,Gainza,PH051713000,2206,1295,334,7,89,397,8,0,5,6,2141,65,0.194301728,416
Region V (Bicol Region),PH050000000,Camarines Sur,PH051700000,Garchitorena,PH051714000,5094,991,197,1,803,3026,4,0,0,0,5022,72,0.603345281,3030
Region V (Bicol Region),PH050000000,Camarines Sur,PH051700000,Goa,PH051715000,12791,6723,1528,6,355,4024,29,1,35,65,12766,25,0.325317249,4153
Region V (Bicol Region),PH050000000,Camarines Sur,PH051700000,City of Iriga,PH051716000,21717,14649,2155,30,717,4013,21,12,23,20,21640,77,0.188401109,4077
Region V (Bicol Region),PH050000000,Camarines Sur,PH051700000,Lagonoy,PH051717000,11176,5453,782,4,864,4041,11,2,1,3,11161,15,0.363408297,4056
Region V (Bicol Region),PH050000000,Camarines Sur,PH051700000,Libmanan,PH051718000,23343,10029,3301,9,919,8782,41,4,8,40,23133,210,0.383478148,8871
Region V (Bicol Region),PH050000000,Camarines Sur,PH051700000,Lupi,PH051719000,6996,3239,1656,2,134,1921,3,1,3,5,6964,32,0.277426766,1932
Region V (Bicol Region),PH050000000,Camarines Sur,PH051700000,Magarao,PH051720000,5317,3000,384,10,330,1549,22,1,4,4,5304,13,0.297699849,1579
Region V (Bicol Region),PH050000000,Camarines Sur,PH051700000,Milaor,PH051721000,6154,3610,975,14,157,1345,9,1,0,2,6113,41,0.221822346,1356
Region V (Bicol Region),PH050000000,Camarines Sur,PH051700000,Minalabac,PH051722000,10263,4358,1116,30,723,3924,22,5,9,12,10199,64,0.388959702,3967
Region V (Bicol Region),PH050000000,Camarines Sur,PH051700000,Nabua,PH051723000,16509,10186,898,17,1162,4056,30,4,8,18,16379,130,0.251053178,4112
Region V (Bicol Region),PH050000000,Camarines Sur,PH051700000,City of Naga,PH051724000,41280,30691,5347,73,827,3879,90,15,77,76,41075,205,0.100353013,4122
Region V (Bicol Region),PH050000000,Camarines Sur,PH051700000,Ocampo,PH051725000,9267,4551,1255,36,216,3021,28,6,13,68,9194,73,0.340439417,3130
Region V (Bicol Region),PH050000000,Camarines Sur,PH051700000,Pamplona,PH051726000,7567,3847,1316,16,188,2062,25,3,4,12,7473,94,0.281413087,2103
Region V (Bicol Region),PH050000000,Camarines Sur,PH051700000,Pasacao,PH051727000,9838,3758,1054,2,1008,3953,13,0,1,1,9790,48,0.405311542,3968
Region V (Bicol Region),PH050000000,Camarines Sur,PH051700000,Pili (Capital),PH051728000,18062,10999,1465,42,828,4407,49,25,28,59,17902,160,0.253770528,4543
Region V (Bicol Region),PH050000000,Camarines Sur,PH051700000,Presentacion (Parubcan),PH051729000,4038,1595,532,4,344,1512,11,3,5,6,4012,26,0.382352941,1534
Region V (Bicol Region),PH050000000,Camarines Sur,PH051700000,Ragay,PH051730000,12453,5592,1852,10,627,4141,32,0,35,27,12316,137,0.343861643,4235
Region V (Bicol Region),PH050000000,Camarines Sur,PH051700000,Sagñay,PH051731000,6947,2939,1095,21,199,2435,90,4,48,26,6857,90,0.37902873,2599
Region V (Bicol Region),PH050000000,Camarines Sur,PH051700000,San Fernando,PH051732000,7214,3749,875,18,460,2065,12,1,4,4,7188,26,0.290066778,2085
Region V (Bicol Region),PH050000000,Camarines Sur,PH051700000,San Jose,PH051733000,8597,5015,401,10,549,2555,29,1,2,12,8574,23,0.303009097,2598
Region V (Bicol Region),PH050000000,Camarines Sur,PH051700000,Sipocot,PH051734000,13472,6551,3010,10,275,3542,7,2,9,14,13420,52,0.266169896,3572
Region V (Bicol Region),PH050000000,Camarines Sur,PH051700000,Siruma,PH051735000,3762,994,166,4,413,2136,18,18,6,5,3760,2,0.575797872,2165
Region V (Bicol Region),PH050000000,Camarines Sur,PH051700000,Tigaon,PH051736000,11444,5970,1148,7,317,3806,21,6,23,29,11327,117,0.342456078,3879
Region V (Bicol Region),PH050000000,Camarines Sur,PH051700000,Tinambac,PH051737000,13277,4191,1093,3,1075,6853,18,0,4,12,13249,28,0.519812816,6887
Region V (Bicol Region),PH050000000,Catanduanes,PH052000000,Bagamanoc,PH052001000,2408,1018,182,1,181,980,4,1,15,7,2389,19,0.421096693,1006
Region V (Bicol Region),PH050000000,Catanduanes,PH052000000,Baras,PH052002000,2798,1430,298,7,157,881,9,1,2,5,2790,8,0.321505376,897
Region V (Bicol Region),PH050000000,Catanduanes,PH052000000,Bato,PH052003000,4517,2506,846,19,192,868,19,3,4,10,4467,50,0.201701366,901
Region V (Bicol Region),PH050000000,Catanduanes,PH052000000,Caramoran,PH052004000,5865,2343,1286,0,228,1958,12,0,7,7,5841,24,0.339667865,1984
Region V (Bicol Region),PH050000000,Catanduanes,PH052000000,Gigmoto,PH052005000,1744,779,389,19,60,438,32,4,9,7,1737,7,0.279792746,486
Region V (Bicol Region),PH050000000,Catanduanes,PH052000000,Pandan,PH052006000,4192,1801,559,22,266,1365,66,16,4,63,4162,30,0.359923114,1498
Region V (Bicol Region),PH050000000,Catanduanes,PH052000000,Panganiban (Payo),PH052007000,2007,1060,182,1,121,621,7,0,1,0,1993,14,0.315604616,629
Region V (Bicol Region),PH050000000,Catanduanes,PH052000000,San Andres (Calolbon),PH052008000,7646,4367,1205,6,321,1685,16,0,9,2,7611,35,0.22493759,1712
Region V (Bicol Region),PH050000000,Catanduanes,PH052000000,San Miguel,PH052009000,3029,1542,880,12,41,487,3,0,8,6,2979,50,0.16918429,504
Region V (Bicol Region),PH050000000,Catanduanes,PH052000000,Viga,PH052010000,4318,1792,380,4,338,1741,14,1,10,9,4289,29,0.413616228,1774
Region V (Bicol Region),PH050000000,Catanduanes,PH052000000,Virac (Capital),PH052011000,14958,9880,2307,37,454,2099,39,3,17,13,14849,109,0.146003098,2168
Region V (Bicol Region),PH050000000,Masbate,PH054100000,Aroroy,PH054101000,17039,6594,3637,13,367,6299,11,0,16,4,16941,98,0.373649726,6330
Region V (Bicol Region),PH050000000,Masbate,PH054100000,Baleno,PH054102000,5341,1808,803,2,232,2475,0,0,3,1,5324,17,0.465627348,2479
Region V (Bicol Region),PH050000000,Masbate,PH054100000,Balud,PH054103000,7843,3037,1618,14,143,2798,18,12,119,52,7811,32,0.382409423,2987
Region V (Bicol Region),PH050000000,Masbate,PH054100000,Batuan,PH054104000,3587,852,182,0,270,2263,7,1,0,0,3575,12,0.634965035,2270
Region V (Bicol Region),PH050000000,Masbate,PH054100000,Cataingan,PH054105000,10764,3831,3753,66,84,2710,9,18,33,20,10524,240,0.263397948,2772
Region V (Bicol Region),PH050000000,Masbate,PH054100000,Cawayan,PH054106000,15039,4605,5432,33,58,4683,34,0,16,34,14895,144,0.320040282,4767
Region V (Bicol Region),PH050000000,Masbate,PH054100000,City of Masbate (Capital),PH054111000,19083,7941,8022,70,78,2721,15,1,53,21,18922,161,0.148504386,2810
Region V (Bicol Region),PH050000000,Masbate,PH054100000,Claveria,PH054107000,9159,2218,1237,12,427,5158,24,0,1,6,9083,76,0.57128702,5189
Region V (Bicol Region),PH050000000,Masbate,PH054100000,Dimasalang,PH054108000,5386,1639,926,7,179,2537,80,1,0,4,5373,13,0.487809417,2621
Region V (Bicol Region),PH050000000,Masbate,PH054100000,Esperanza,PH054109000,4062,1622,950,17,95,968,25,0,3,9,3689,373,0.272431553,1005
Region V (Bicol Region),PH050000000,Masbate,PH054100000,Mandaon,PH054110000,8724,3087,2364,23,122,3053,14,1,14,6,8684,40,0.355481345,3087
Region V (Bicol Region),PH050000000,Masbate,PH054100000,Milagros,PH054112000,11439,4143,2749,28,197,4134,11,5,12,120,11399,40,0.375208352,4277
Region V (Bicol Region),PH050000000,Masbate,PH054100000,Mobo,PH054113000,7721,2681,1842,3,196,2946,13,1,21,9,7712,9,0.387577801,2989
Region V (Bicol Region),PH050000000,Masbate,PH054100000,Monreal,PH054114000,5256,1076,451,16,241,3349,29,9,4,70,5245,11,0.65815062,3452
Region V (Bicol Region),PH050000000,Masbate,PH054100000,Palanas,PH054115000,5843,1770,1512,1,171,2365,3,0,3,0,5825,18,0.407038627,2371
Region V (Bicol Region),PH050000000,Masbate,PH054100000,Pio V. Corpuz (Limbuhan),PH054116000,5269,2108,1483,7,115,1056,4,1,4,8,4786,483,0.223986628,1072
Region V (Bicol Region),PH050000000,Masbate,PH054100000,Placer,PH054117000,11934,3599,4110,20,151,3971,13,1,4,20,11889,45,0.337118345,4008
Region V (Bicol Region),PH050000000,Masbate,PH054100000,San Fernando,PH054118000,5397,1429,354,1,324,3266,4,7,8,1,5394,3,0.607897664,3279
Region V (Bicol Region),PH050000000,Masbate,PH054100000,San Jacinto,PH054119000,7060,2122,327,0,582,4015,6,3,1,1,7057,3,0.570072269,4023
Region V (Bicol Region),PH050000000,Masbate,PH054100000,San Pascual,PH054120000,9819,2589,1436,9,331,5189,23,4,26,168,9775,44,0.553043478,5406
Region V (Bicol Region),PH050000000,Masbate,PH054100000,Uson,PH054121000,11534,3324,2659,42,243,4656,84,3,19,106,11136,398,0.436871408,4865
Region V (Bicol Region),PH050000000,Sorsogon,PH056200000,Barcelona,PH056202000,4788,2818,414,0,421,1119,4,1,2,1,4780,8,0.235564854,1126
Region V (Bicol Region),PH050000000,Sorsogon,PH056200000,Bulan,PH056203000,20598,6979,452,2,5134,7968,30,1,2,4,20572,26,0.389072526,8004
Region V (Bicol Region),PH050000000,Sorsogon,PH056200000,Bulusan,PH056204000,5285,2663,233,5,1008,1339,25,0,1,0,5274,11,0.258816837,1365
Region V (Bicol Region),PH050000000,Sorsogon,PH056200000,Casiguran,PH056205000,7088,4654,1087,6,217,1068,10,0,0,3,7045,43,0.153442158,1081
Region V (Bicol Region),PH050000000,Sorsogon,PH056200000,Castilla,PH056206000,12266,4518,488,2,2060,5152,17,0,0,5,12242,24,0.422643359,5174
Region V (Bicol Region),PH050000000,Sorsogon,PH056200000,City of Sorsogon (Capital),PH056216000,35207,23568,3989,89,1345,5733,79,22,14,59,34898,309,0.168634306,5885
Region V (Bicol Region),PH050000000,Sorsogon,PH056200000,Donsol,PH056207000,10252,2580,291,1,1808,5520,22,2,8,8,10240,12,0.542773438,5558
Region V (Bicol Region),PH050000000,Sorsogon,PH056200000,Gubat,PH056208000,13454,7884,1186,21,964,3267,48,2,7,18,13397,57,0.249309547,3340
Region V (Bicol Region),PH050000000,Sorsogon,PH056200000,Irosin,PH056209000,11395,5730,404,6,2212,2931,21,5,34,8,11351,44,0.263765307,2994
Region V (Bicol Region),PH050000000,Sorsogon,PH056200000,Juban,PH056210000,6636,3512,635,9,471,1993,14,0,2,0,6636,0,0.302742616,2009
Region V (Bicol Region),PH050000000,Sorsogon,PH056200000,Magallanes,PH056211000,7470,2259,337,3,1447,3386,31,0,0,1,7464,6,0.457931404,3418
Region V (Bicol Region),PH050000000,Sorsogon,PH056200000,Matnog,PH056212000,8347,1989,159,0,2159,4021,11,2,0,2,8343,4,0.483519118,4034
Region V (Bicol Region),PH050000000,Sorsogon,PH056200000,Pilar,PH056213000,14960,4829,556,6,2239,7160,24,8,9,8,14839,121,0.485275288,7201
Region V (Bicol Region),PH050000000,Sorsogon,PH056200000,Prieto Diaz,PH056214000,4773,2730,590,6,216,1214,6,0,3,3,4768,5,0.257130872,1226
Region V (Bicol Region),PH050000000,Sorsogon,PH056200000,Santa Magdalena,PH056215000,3587,1292,165,0,684,1421,5,0,0,0,3567,20,0.399775722,1426
Region VI (Western Visayas),PH060000000,Aklan,PH060400000,Altavas,PH060401000,5950,2661,1781,33,151,1247,13,1,4,45,5936,14,0.220518868,1309
Region VI (Western Visayas),PH060000000,Aklan,PH060400000,Balete,PH060402000,6974,2004,2368,10,235,2298,5,12,24,7,6963,11,0.335200345,2334
Region VI (Western Visayas),PH060000000,Aklan,PH060400000,Banga,PH060403000,9243,5097,1964,37,455,1652,20,1,3,1,9230,13,0.181581798,1676
Region VI (Western Visayas),PH060000000,Aklan,PH060400000,Batan,PH060404000,7929,3740,1516,14,436,2159,22,4,13,16,7920,9,0.279040404,2210
Region VI (Western Visayas),PH060000000,Aklan,PH060400000,Buruanga,PH060405000,4219,2153,1146,5,66,836,2,0,1,1,4210,9,0.199524941,840
Region VI (Western Visayas),PH060000000,Aklan,PH060400000,Ibajay,PH060406000,10931,6514,2262,27,239,1817,17,2,8,19,10905,26,0.170655663,1861
Region VI (Western Visayas),PH060000000,Aklan,PH060400000,Kalibo (Capital),PH060407000,17784,11151,2232,17,930,3375,15,6,21,9,17756,28,0.192610948,3420
Region VI (Western Visayas),PH060000000,Aklan,PH060400000,Lezo,PH060408000,3491,2071,297,0,181,919,1,6,2,6,3483,8,0.26643698,928
Region VI (Western Visayas),PH060000000,Aklan,PH060400000,Libacao,PH060409000,6556,1705,1619,1,170,3018,4,2,12,5,6536,20,0.46496328,3039
Region VI (Western Visayas),PH060000000,Aklan,PH060400000,Madalag,PH060410000,4239,1217,1628,2,124,1259,2,0,0,0,4232,7,0.297967864,1261
Region VI (Western Visayas),PH060000000,Aklan,PH060400000,Makato,PH060411000,6538,2683,1150,3,424,2043,14,136,66,7,6526,12,0.326386761,2130
Region VI (Western Visayas),PH060000000,Aklan,PH060400000,Malay,PH060412000,12618,5637,2307,3,514,4090,14,3,2,4,12574,44,0.326864959,4110
Region VI (Western Visayas),PH060000000,Aklan,PH060400000,Malinao,PH060413000,5411,2511,1203,10,191,1478,6,0,2,0,5401,10,0.275134234,1486
Region VI (Western Visayas),PH060000000,Aklan,PH060400000,Nabas,PH060414000,7829,4648,876,26,391,1828,8,8,15,17,7817,12,0.238966355,1868
Region VI (Western Visayas),PH060000000,Aklan,PH060400000,New Washington,PH060415000,10820,6352,1134,18,810,2314,49,24,18,91,10810,10,0.228677151,2472
Region VI (Western Visayas),PH060000000,Aklan,PH060400000,Numancia,PH060416000,7332,4705,822,12,452,1328,4,1,3,2,7329,3,0.182425979,1337
Region VI (Western Visayas),PH060000000,Aklan,PH060400000,Tangalan,PH060417000,4920,2395,795,3,359,1352,3,0,2,6,4915,5,0.277314344,1363
Region VI (Western Visayas),PH060000000,Antique,PH060600000,Anini-Y,PH060601000,4611,1739,1445,2,104,1308,6,0,1,5,4610,1,0.286334056,1320
Region VI (Western Visayas),PH060000000,Antique,PH060600000,Barbaza,PH060602000,5439,2602,2138,7,41,626,1,0,0,1,5416,23,0.115952733,628
Region VI (Western Visayas),PH060000000,Antique,PH060600000,Belison,PH060603000,3051,1986,586,1,42,422,1,0,1,0,3039,12,0.139519579,424
Region VI (Western Visayas),PH060000000,Antique,PH060600000,Bugasong,PH060604000,7341,3112,3217,14,76,844,5,0,1,1,7270,71,0.117056396,851
Region VI (Western Visayas),PH060000000,Antique,PH060600000,Caluya,PH060605000,7978,3360,2429,43,43,1975,11,3,18,31,7913,65,0.257171743,2035
Region VI (Western Visayas),PH060000000,Antique,PH060600000,Culasi,PH060606000,9472,4964,2779,25,75,1557,7,1,0,3,9411,61,0.166507279,1567
Region VI (Western Visayas),PH060000000,Antique,PH060600000,Hamtic,PH060608000,10501,4646,2797,10,244,2581,4,0,3,8,10293,208,0.25221024,2596
Region VI (Western Visayas),PH060000000,Antique,PH060600000,Laua-An,PH060609000,5944,2401,2979,36,16,443,12,0,13,15,5915,29,0.081656805,483
Region VI (Western Visayas),PH060000000,Antique,PH060600000,Libertad,PH060610000,3633,1822,476,3,127,1200,2,0,0,0,3630,3,0.331129477,1202
Region VI (Western Visayas),PH060000000,Antique,PH060600000,Pandan,PH060611000,7760,4478,1683,12,219,1285,9,4,11,4,7705,55,0.169889682,1309
Region VI (Western Visayas),PH060000000,Antique,PH060600000,Patnongon,PH060612000,8540,3421,3048,3,111,1908,0,4,0,3,8498,42,0.224876442,1911
Region VI (Western Visayas),PH060000000,Antique,PH060600000,San Jose (Capital),PH060613000,13488,7507,2569,13,324,2926,13,3,8,25,13388,100,0.221989842,2972
Region VI (Western Visayas),PH060000000,Antique,PH060600000,San Remigio,PH060614000,6579,1789,4228,6,9,519,0,0,2,1,6554,25,0.079646018,522
Region VI (Western Visayas),PH060000000,Antique,PH060600000,Sebaste,PH060615000,3983,2239,1252,21,39,402,0,1,1,16,3971,12,0.105514984,419
Region VI (Western Visayas),PH060000000,Antique,PH060600000,Sibalom,PH060616000,13186,6319,5923,12,33,842,1,1,1,0,13132,54,0.064270484,844
Region VI (Western Visayas),PH060000000,Antique,PH060600000,Tibiao,PH060617000,6233,2946,2323,78,30,657,33,2,18,120,6207,26,0.133397777,828
Region VI (Western Visayas),PH060000000,Antique,PH060600000,Tobias Fornier (Dao),PH060607000,6863,2507,2751,1,68,1519,0,0,2,0,6848,15,0.222108645,1521
Region VI (Western Visayas),PH060000000,Antique,PH060600000,Valderrama,PH060618000,4151,1539,2204,3,2,369,0,0,1,2,4120,31,0.090291262,372
Region VI (Western Visayas),PH060000000,Capiz,PH061900000,Cuartero,PH061901000,6428,2820,3254,20,41,281,0,0,0,1,6417,11,0.043945769,282
Region VI (Western Visayas),PH060000000,Capiz,PH061900000,Dao,PH061902000,7720,4176,3199,37,16,233,1,5,8,12,7687,33,0.0330428,254
Region VI (Western Visayas),PH060000000,Capiz,PH061900000,Dumalag,PH061903000,7028,3285,3625,30,0,50,1,0,2,0,6993,35,0.007579008,53
Region VI (Western Visayas),PH060000000,Capiz,PH061900000,Dumarao,PH061904000,10988,4188,6259,25,15,431,7,0,9,9,10943,45,0.041670474,456
Region VI (Western Visayas),PH060000000,Capiz,PH061900000,Ivisan,PH061905000,6622,3437,2443,41,29,555,9,2,32,21,6569,53,0.093926016,617
Region VI (Western Visayas),PH060000000,Capiz,PH061900000,Jamindan,PH061906000,8540,2688,3559,15,99,2094,7,0,14,16,8492,48,0.250942063,2131
Region VI (Western Visayas),PH060000000,Capiz,PH061900000,Ma-Ayon,PH061907000,9245,4114,4682,58,12,299,6,2,4,8,9185,60,0.034512793,317
Region VI (Western Visayas),PH060000000,Capiz,PH061900000,Mambusao,PH061908000,9661,4739,4295,86,15,420,13,2,34,33,9637,24,0.051883366,500
Region VI (Western Visayas),PH060000000,Capiz,PH061900000,Panay,PH061909000,10938,4970,4825,83,67,900,17,4,4,2,10872,66,0.084896983,923
Region VI (Western Visayas),PH060000000,Capiz,PH061900000,Panitan,PH061910000,9558,5609,3118,142,22,575,14,2,7,44,9533,25,0.067135215,640
Region VI (Western Visayas),PH060000000,Capiz,PH061900000,Pilar,PH061911000,10678,4578,3926,42,133,1913,20,1,14,25,10652,26,0.185129553,1972
Region VI (Western Visayas),PH060000000,Capiz,PH061900000,Pontevedra,PH061912000,11150,5592,3859,163,60,1287,28,4,16,64,11073,77,0.125982119,1395
Region VI (Western Visayas),PH060000000,Capiz,PH061900000,President Roxas,PH061913000,6883,3738,2412,78,35,505,20,2,10,17,6817,66,0.080974035,552
Region VI (Western Visayas),PH060000000,Capiz,PH061900000,City of Roxas (Capital),PH061914000,37291,20945,12506,325,235,2743,71,8,38,86,36957,334,0.079497795,2938
Region VI (Western Visayas),PH060000000,Capiz,PH061900000,Sapi-An,PH061915000,6106,2264,2664,19,39,1040,2,13,23,24,6088,18,0.178876478,1089
Region VI (Western Visayas),PH060000000,Capiz,PH061900000,Sigma,PH061916000,7373,3076,3820,62,9,316,9,1,12,29,7334,39,0.049904554,366
Region VI (Western Visayas),PH060000000,Capiz,PH061900000,Tapaz,PH061917000,12094,3164,7233,29,41,1566,2,1,6,11,12053,41,0.13150253,1585
Region VI (Western Visayas),PH060000000,Guimaras,PH067900000,Buenavista,PH067901000,12077,6872,3950,11,39,1178,5,0,1,2,12058,19,0.098357937,1186
Region VI (Western Visayas),PH060000000,Guimaras,PH067900000,Jordan (Capital),PH067902000,8304,3752,3769,7,19,683,5,1,8,13,8257,47,0.085866537,709
Region VI (Western Visayas),PH060000000,Guimaras,PH067900000,Nueva Valencia,PH067903000,9157,3781,2987,22,89,2197,21,5,21,12,9135,22,0.246414888,2251
Region VI (Western Visayas),PH060000000,Guimaras,PH067900000,San Lorenzo,PH067904000,5991,2520,2641,1,24,770,2,0,0,0,5958,33,0.129573682,772
Region VI (Western Visayas),PH060000000,Guimaras,PH067900000,Sibunag,PH067905000,4968,1903,2030,23,39,912,0,0,0,0,4907,61,0.185856939,912
Region VI (Western Visayas),PH060000000,Iloilo,PH063000000,Ajuy,PH063001000,12162,5271,4706,110,91,1832,24,8,20,49,12111,51,0.158946412,1925
Region VI (Western Visayas),PH060000000,Iloilo,PH063000000,Alimodian,PH063002000,8057,3326,4453,4,2,179,0,1,3,2,7970,87,0.023086575,184
Region VI (Western Visayas),PH060000000,Iloilo,PH063000000,Anilao,PH063003000,6509,2669,3364,17,6,413,5,1,4,7,6486,23,0.066142461,429
Region VI (Western Visayas),PH060000000,Iloilo,PH063000000,Badiangan,PH063004000,5878,2459,3114,6,8,278,0,0,3,1,5869,9,0.048049071,282
Region VI (Western Visayas),PH060000000,Iloilo,PH063000000,Balasan,PH063005000,8083,3476,1642,94,95,2512,62,3,34,133,8051,32,0.340454602,2741
Region VI (Western Visayas),PH060000000,Iloilo,PH063000000,Banate,PH063006000,7664,3432,3425,20,24,693,5,1,6,13,7619,45,0.094106838,717
Region VI (Western Visayas),PH060000000,Iloilo,PH063000000,Barotac Nuevo,PH063007000,11935,6027,4550,20,45,1197,2,3,6,4,11854,81,0.101990889,1209
Region VI (Western Visayas),PH060000000,Iloilo,PH063000000,Barotac Viejo,PH063008000,11076,4322,5779,73,16,771,11,2,19,21,11014,62,0.074632286,822
Region VI (Western Visayas),PH060000000,Iloilo,PH063000000,Batad,PH063009000,5143,2199,2172,39,16,616,11,2,4,28,5087,56,0.129545901,659
Region VI (Western Visayas),PH060000000,Iloilo,PH063000000,Bingawan,PH063010000,3429,1339,2011,23,0,41,1,0,0,3,3418,11,0.013165594,45
Region VI (Western Visayas),PH060000000,Iloilo,PH063000000,Cabatuan,PH063012000,12689,6142,6051,4,32,433,1,1,0,0,12664,25,0.034270373,434
Region VI (Western Visayas),PH060000000,Iloilo,PH063000000,Calinog,PH063013000,13069,4786,7559,76,4,549,1,0,8,12,12995,74,0.043863024,570
Region VI (Western Visayas),PH060000000,Iloilo,PH063000000,Carles,PH063014000,15249,6389,4278,155,280,3592,92,22,56,103,14967,282,0.256764883,3843
Region VI (Western Visayas),PH060000000,Iloilo,PH063000000,City of Passi,PH063035000,19027,8394,8622,121,201,1376,3,1,8,12,18738,289,0.074661116,1399
Region VI (Western Visayas),PH060000000,Iloilo,PH063000000,Concepcion,PH063015000,10044,4120,4143,113,57,1219,54,8,38,50,9802,242,0.138849214,1361
Region VI (Western Visayas),PH060000000,Iloilo,PH063000000,Dingle,PH063016000,10365,5155,4005,5,28,946,3,0,5,2,10149,216,0.094196473,956
Region VI (Western Visayas),PH060000000,Iloilo,PH063000000,Dueñas,PH063017000,7812,3485,3961,7,7,209,2,0,2,3,7676,136,0.028139656,216
Region VI (Western Visayas),PH060000000,Iloilo,PH063000000,Dumangas,PH063018000,15640,7703,6463,59,24,948,7,0,5,13,15222,418,0.063920641,973
Region VI (Western Visayas),PH060000000,Iloilo,PH063000000,Estancia,PH063019000,11102,5094,4284,99,115,1152,30,6,20,181,10981,121,0.125944814,1383
Region VI (Western Visayas),PH060000000,Iloilo,PH063000000,Guimbal,PH063020000,7446,4202,2400,6,57,711,2,0,2,0,7380,66,0.096883469,715
Region VI (Western Visayas),PH060000000,Iloilo,PH063000000,Igbaras,PH063021000,7009,2652,4192,0,3,129,0,0,0,0,6976,33,0.018491972,129
Region VI (Western Visayas),PH060000000,Iloilo,PH063000000,City of Iloilo (Capital),PH063022000,91487,62269,24339,402,161,3073,60,51,90,174,90619,868,0.03748662,3397
Region VI (Western Visayas),PH060000000,Iloilo,PH063000000,Janiuay,PH063023000,13792,5395,7249,5,44,1015,2,0,1,1,13712,80,0.074314469,1019
Region VI (Western Visayas),PH060000000,Iloilo,PH063000000,Lambunao,PH063025000,15692,5823,9004,13,18,692,6,2,3,4,15565,127,0.045293929,705
Region VI (Western Visayas),PH060000000,Iloilo,PH063000000,Leganes,PH063026000,7018,3391,2363,6,74,1119,3,0,1,2,6959,59,0.161661158,1125
Region VI (Western Visayas),PH060000000,Iloilo,PH063000000,Lemery,PH063027000,7773,2716,4541,193,2,157,18,1,39,46,7713,60,0.033709322,260
Region VI (Western Visayas),PH060000000,Iloilo,PH063000000,Leon,PH063028000,10739,4325,6084,8,2,245,1,0,3,3,10671,68,0.023615406,252
Region VI (Western Visayas),PH060000000,Iloilo,PH063000000,Maasin,PH063029000,7357,2854,4041,1,43,387,0,0,1,0,7327,30,0.052954825,388
Region VI (Western Visayas),PH060000000,Iloilo,PH063000000,Miagao,PH063030000,14039,6784,5873,16,43,1245,2,0,5,7,13975,64,0.090089445,1259
Region VI (Western Visayas),PH060000000,Iloilo,PH063000000,Mina,PH063031000,4981,2333,2125,2,18,475,2,1,1,1,4958,23,0.096611537,479
Region VI (Western Visayas),PH060000000,Iloilo,PH063000000,New Lucena,PH063032000,5001,2398,2380,0,4,173,0,0,0,0,4955,46,0.034914228,173
Region VI (Western Visayas),PH060000000,Iloilo,PH063000000,Oton,PH063034000,20203,11398,6428,31,121,2058,14,1,15,29,20095,108,0.105299826,2116
Region VI (Western Visayas),PH060000000,Iloilo,PH063000000,Pavia,PH063036000,12703,9146,2873,29,25,360,1,1,7,5,12447,256,0.02996706,373
Region VI (Western Visayas),PH060000000,Iloilo,PH063000000,Pototan,PH063037000,15941,8454,5362,17,84,1754,6,32,169,8,15886,55,0.12193126,1937
Region VI (Western Visayas),PH060000000,Iloilo,PH063000000,San Dionisio,PH063038000,8961,3517,4406,398,25,415,29,2,48,56,8896,65,0.061600719,548
Region VI (Western Visayas),PH060000000,Iloilo,PH063000000,San Enrique,PH063039000,7618,3547,3343,24,25,600,2,2,4,12,7559,59,0.081756846,618
Region VI (Western Visayas),PH060000000,Iloilo,PH063000000,San Joaquin,PH063040000,11079,4229,5225,9,73,1428,3,0,3,5,10975,104,0.131116173,1439
Region VI (Western Visayas),PH060000000,Iloilo,PH063000000,San Miguel,PH063041000,6028,3064,2615,7,11,299,0,0,1,2,5999,29,0.050341724,302
Region VI (Western Visayas),PH060000000,Iloilo,PH063000000,San Rafael,PH063042000,3826,1484,2101,22,5,93,2,0,1,3,3711,115,0.026677445,99
Region VI (Western Visayas),PH060000000,Iloilo,PH063000000,Santa Barbara,PH063043000,13518,7030,5386,26,48,899,7,0,6,3,13405,113,0.068258113,915
Region VI (Western Visayas),PH060000000,Iloilo,PH063000000,Sara,PH063044000,13122,6157,5876,386,28,218,14,10,33,346,13068,54,0.046755433,611
Region VI (Western Visayas),PH060000000,Iloilo,PH063000000,Tigbauan,PH063045000,13304,6514,5006,15,117,1564,7,1,7,14,13245,59,0.1201963,1592
Region VI (Western Visayas),PH060000000,Iloilo,PH063000000,Tubungan,PH063046000,4840,1843,2834,3,2,124,0,0,0,0,4806,34,0.025801082,124
Region VI (Western Visayas),PH060000000,Iloilo,PH063000000,Zarraga,PH063047000,5848,3230,1900,15,20,651,3,1,1,1,5822,26,0.112676056,656
Region VII (Central Visayas),PH070000000,Bohol,PH071200000,Alburquerque,PH071201000,2395,1410,771,0,10,186,1,0,0,1,2379,16,0.0790248,188
Region VII (Central Visayas),PH070000000,Bohol,PH071200000,Alicia,PH071202000,5095,2583,1868,7,21,595,1,2,2,3,5082,13,0.118260527,601
Region VII (Central Visayas),PH070000000,Bohol,PH071200000,Anda,PH071203000,3755,2285,956,32,39,399,10,2,8,6,3737,18,0.1131924,423
Region VII (Central Visayas),PH070000000,Bohol,PH071200000,Antequera,PH071204000,3478,2034,1269,1,0,43,0,0,0,0,3347,131,0.012847326,43
Region VII (Central Visayas),PH070000000,Bohol,PH071200000,Baclayon,PH071205000,4358,2864,1211,2,13,246,1,0,2,0,4339,19,0.057386495,249
Region VII (Central Visayas),PH070000000,Bohol,PH071200000,Balilihan,PH071206000,4080,2459,1501,11,3,81,2,0,1,5,4063,17,0.021904996,89
Region VII (Central Visayas),PH070000000,Bohol,PH071200000,Batuan,PH071207000,2848,1598,1220,4,0,23,0,1,0,2,2848,0,0.00877809,25
Region VII (Central Visayas),PH070000000,Bohol,PH071200000,Bien Unido,PH071248000,5604,2954,958,21,96,1505,20,2,4,8,5568,36,0.276041667,1537
Region VII (Central Visayas),PH070000000,Bohol,PH071200000,Bilar,PH071208000,3758,2149,1454,2,10,125,0,0,1,0,3741,17,0.033680834,126
Region VII (Central Visayas),PH070000000,Bohol,PH071200000,Buenavista,PH071209000,5868,2487,2103,10,36,1215,4,1,3,1,5860,8,0.208703072,1223
Region VII (Central Visayas),PH070000000,Bohol,PH071200000,Calape,PH071210000,7396,3914,3012,16,13,414,3,0,1,3,7376,20,0.057077007,421
Region VII (Central Visayas),PH070000000,Bohol,PH071200000,Candijay,PH071211000,6762,3939,1349,2,144,1306,0,0,3,0,6743,19,0.194127243,1309
Region VII (Central Visayas),PH070000000,Bohol,PH071200000,Carmen,PH071212000,10264,5287,4688,16,4,226,0,0,2,0,10223,41,0.022302651,228
Region VII (Central Visayas),PH070000000,Bohol,PH071200000,Catigbian,PH071213000,5117,2903,2035,11,6,158,0,0,0,3,5116,1,0.031469898,161
Region VII (Central Visayas),PH070000000,Bohol,PH071200000,Clarin,PH071214000,4600,2056,2009,76,11,398,26,0,6,9,4591,9,0.095621869,439
Region VII (Central Visayas),PH070000000,Bohol,PH071200000,Corella,PH071215000,1900,1146,661,2,6,58,1,0,0,0,1874,26,0.031483458,59
Region VII (Central Visayas),PH070000000,Bohol,PH071200000,Cortes,PH071216000,3611,2359,832,52,13,320,3,0,1,12,3592,19,0.093541203,336
Region VII (Central Visayas),PH070000000,Bohol,PH071200000,Dagohoy,PH071217000,4170,2189,1775,9,10,175,1,0,2,1,4162,8,0.043008169,179
Region VII (Central Visayas),PH070000000,Bohol,PH071200000,Danao,PH071218000,3892,1782,1748,4,3,324,1,0,4,1,3867,25,0.085337471,330
Region VII (Central Visayas),PH070000000,Bohol,PH071200000,Dauis,PH071219000,9806,6498,2845,31,29,337,3,2,6,13,9764,42,0.036767718,359
Region VII (Central Visayas),PH070000000,Bohol,PH071200000,Dimiao,PH071220000,3219,2099,1038,5,4,67,0,0,0,0,3213,6,0.020852786,67
Region VII (Central Visayas),PH070000000,Bohol,PH071200000,Duero,PH071221000,4000,2513,1132,5,29,316,2,0,0,1,3998,2,0.079789895,319
Region VII (Central Visayas),PH070000000,Bohol,PH071200000,Garcia Hernandez,PH071222000,4967,3351,1195,0,38,365,0,0,0,1,4950,17,0.073939394,366
Region VII (Central Visayas),PH070000000,Bohol,PH071200000,Getafe,PH071226000,6423,2630,2011,29,50,1587,22,12,44,15,6400,23,0.260625,1668
Region VII (Central Visayas),PH070000000,Bohol,PH071200000,Guindulman,PH071223000,7218,4572,1656,4,99,869,2,0,4,0,7206,12,0.121426589,875
Region VII (Central Visayas),PH070000000,Bohol,PH071200000,Inabanga,PH071224000,9786,4429,3696,39,57,1488,27,5,5,2,9748,38,0.156134592,1522
Region VII (Central Visayas),PH070000000,Bohol,PH071200000,Jagna,PH071225000,7485,5143,1887,10,35,379,3,1,6,2,7466,19,0.052236807,390
Region VII (Central Visayas),PH070000000,Bohol,PH071200000,Lila,PH071227000,2082,1468,487,1,14,112,0,0,0,0,2082,0,0.053794428,112
Region VII (Central Visayas),PH070000000,Bohol,PH071200000,Loay,PH071228000,3562,1997,984,0,23,525,0,2,22,1,3554,8,0.154192459,548
Region VII (Central Visayas),PH070000000,Bohol,PH071200000,Loboc,PH071229000,3475,2207,1089,2,9,151,0,0,0,0,3458,17,0.043666859,151
Region VII (Central Visayas),PH070000000,Bohol,PH071200000,Loon,PH071230000,9924,5259,4107,40,22,444,12,0,1,9,9894,30,0.047099252,466
Region VII (Central Visayas),PH070000000,Bohol,PH071200000,Mabini,PH071231000,6240,2718,1403,5,110,1959,9,0,5,11,6220,20,0.318971061,1984
Region VII (Central Visayas),PH070000000,Bohol,PH071200000,Maribojoc,PH071232000,4723,2734,1643,31,14,280,4,0,0,3,4709,14,0.060947123,287
Region VII (Central Visayas),PH070000000,Bohol,PH071200000,Panglao,PH071233000,7006,4297,1765,4,64,830,3,2,3,1,6969,37,0.120103315,837
Region VII (Central Visayas),PH070000000,Bohol,PH071200000,Pilar,PH071234000,5961,3295,2348,1,5,292,0,4,0,0,5945,16,0.049116905,292
Region VII (Central Visayas),PH070000000,Bohol,PH071200000,Pres. Carlos P. Garcia (Pitogo),PH071235000,5145,2546,967,8,79,1512,6,1,4,3,5126,19,0.297502926,1525
Region VII (Central Visayas),PH070000000,Bohol,PH071200000,Sagbayan (Borja),PH071236000,5149,2725,2204,34,5,164,1,0,0,1,5134,15,0.032333463,166
Region VII (Central Visayas),PH070000000,Bohol,PH071200000,San Isidro,PH071237000,2194,1275,906,1,0,10,0,0,0,0,2192,2,0.004562044,10
Region VII (Central Visayas),PH070000000,Bohol,PH071200000,San Miguel,PH071238000,5393,2867,1909,28,8,573,1,0,2,1,5389,4,0.107069957,577
Region VII (Central Visayas),PH070000000,Bohol,PH071200000,Sevilla,PH071239000,2238,1311,902,0,1,19,0,0,0,0,2233,5,0.008508733,19
Region VII (Central Visayas),PH070000000,Bohol,PH071200000,Sierra Bullones,PH071240000,5408,3314,1960,31,2,92,4,0,1,0,5404,4,0.017949667,97
Region VII (Central Visayas),PH070000000,Bohol,PH071200000,Sikatuna,PH071241000,1515,968,534,0,0,13,0,0,0,0,1515,0,0.008580858,13
Region VII (Central Visayas),PH070000000,Bohol,PH071200000,City of Tagbilaran (Capital),PH071242000,21423,16145,4326,48,60,625,5,2,5,6,21222,201,0.030204505,641
Region VII (Central Visayas),PH070000000,Bohol,PH071200000,Talibon,PH071243000,14272,7753,3637,30,117,2598,17,4,18,13,14187,85,0.186508776,2646
Region VII (Central Visayas),PH070000000,Bohol,PH071200000,Trinidad,PH071244000,6849,3851,1178,5,88,1692,5,0,1,14,6834,15,0.250512145,1712
Region VII (Central Visayas),PH070000000,Bohol,PH071200000,Tubigon,PH071245000,10265,5444,3967,53,33,661,15,1,8,18,10200,65,0.068823529,702
Region VII (Central Visayas),PH070000000,Bohol,PH071200000,Ubay,PH071246000,16509,8616,3707,20,182,3913,18,2,7,5,16470,39,0.239404979,3943
Region VII (Central Visayas),PH070000000,Bohol,PH071200000,Valencia,PH071247000,5580,3569,1845,4,10,148,0,0,1,1,5578,2,0.026891359,150
Region VII (Central Visayas),PH070000000,Cebu,PH072200000,Alcantara,PH072201000,3416,1622,1605,42,4,107,3,0,1,2,3386,30,0.033372711,113
Region VII (Central Visayas),PH070000000,Cebu,PH072200000,Alcoy,PH072202000,3383,1519,1221,10,35,551,1,1,22,6,3366,17,0.172311349,580
Region VII (Central Visayas),PH070000000,Cebu,PH072200000,Alegria,PH072203000,4969,1775,2097,13,35,983,3,1,39,8,4954,15,0.208518369,1033
Region VII (Central Visayas),PH070000000,Cebu,PH072200000,Aloguinsan,PH072204000,6886,3516,2759,37,8,467,17,0,6,49,6859,27,0.078582884,539
Region VII (Central Visayas),PH070000000,Cebu,PH072200000,Argao,PH072205000,16504,9039,6319,64,45,899,8,3,14,27,16418,86,0.057741503,948
Region VII (Central Visayas),PH070000000,Cebu,PH072200000,Asturias,PH072206000,10211,4570,3867,29,93,1544,20,5,8,25,10161,50,0.15716957,1597
Region VII (Central Visayas),PH070000000,Cebu,PH072200000,Badian,PH072207000,8200,3976,2913,25,62,1146,6,3,14,9,8154,46,0.144101055,1175
Region VII (Central Visayas),PH070000000,Cebu,PH072200000,Balamban,PH072208000,19575,9864,8035,74,38,1375,11,1,25,27,19450,125,0.073933162,1438
Region VII (Central Visayas),PH070000000,Cebu,PH072200000,Bantayan,PH072209000,18354,9376,6125,261,85,1825,148,33,105,317,18275,79,0.131053352,2395
Region VII (Central Visayas),PH070000000,Cebu,PH072200000,Barili,PH072210000,15679,6826,7367,152,40,1127,60,1,16,30,15619,60,0.078942314,1233
Region VII (Central Visayas),PH070000000,Cebu,PH072200000,Boljoon,PH072212000,3353,1204,1668,10,18,410,3,0,7,6,3326,27,0.12808178,426
Region VII (Central Visayas),PH070000000,Cebu,PH072200000,Borbon,PH072213000,8301,4149,3638,97,3,287,12,0,5,16,8207,94,0.038991105,320
Region VII (Central Visayas),PH070000000,Cebu,PH072200000,Carmen,PH072215000,11207,6543,3284,112,24,1061,10,6,23,67,11130,77,0.104312668,1161
Region VII (Central Visayas),PH070000000,Cebu,PH072200000,Catmon,PH072216000,6932,3910,2472,12,15,466,7,2,7,2,6893,39,0.069926012,482
Region VII (Central Visayas),PH070000000,Cebu,PH072200000,City of Cebu (Capital),PH072217000,204409,140151,58635,709,167,2841,85,25,151,434,203198,1211,0.017278713,3511
Region VII (Central Visayas),PH070000000,Cebu,PH072200000,City of Bogo,PH072211000,19217,10267,7877,535,9,231,25,12,25,92,19073,144,0.019556441,373
Region VII (Central Visayas),PH070000000,Cebu,PH072200000,City of Carcar,PH072214000,26585,16763,8426,90,61,933,9,2,29,45,26358,227,0.038546172,1016
Region VII (Central Visayas),PH070000000,Cebu,PH072200000,City of Naga,PH072234000,26011,16476,7837,56,106,1207,6,2,55,35,25780,231,0.050543057,1303
Region VII (Central Visayas),PH070000000,Cebu,PH072200000,City of Talisay,PH072250000,49871,34685,12279,133,338,1835,35,20,67,163,49555,316,0.042377157,2100
Region VII (Central Visayas),PH070000000,Cebu,PH072200000,Compostela,PH072218000,10689,6874,3042,45,21,521,3,0,4,10,10520,169,0.051140684,538
Region VII (Central Visayas),PH070000000,Cebu,PH072200000,Consolacion,PH072219000,30102,21317,7653,131,30,627,14,3,12,18,29805,297,0.022513001,671
Region VII (Central Visayas),PH070000000,Cebu,PH072200000,Cordova,PH072220000,13167,8520,3692,88,38,615,10,3,15,4,12985,182,0.049595687,644
Region VII (Central Visayas),PH070000000,Cebu,PH072200000,Daanbantayan,PH072221000,19732,10301,8365,286,30,338,39,13,58,207,19637,95,0.032693385,642
Region VII (Central Visayas),PH070000000,Cebu,PH072200000,Dalaguete,PH072222000,14266,7636,6005,173,6,276,11,3,11,33,14154,112,0.023385615,331
Region VII (Central Visayas),PH070000000,Cebu,PH072200000,Danao City,PH072223000,31111,20691,8345,185,71,1471,24,20,47,41,30895,216,0.051238064,1583
Region VII (Central Visayas),PH070000000,Cebu,PH072200000,Dumanjug,PH072224000,10912,5148,4941,94,14,601,17,0,12,8,10835,77,0.058883249,638
Region VII (Central Visayas),PH070000000,Cebu,PH072200000,Ginatilan,PH072225000,3366,1324,1310,3,61,645,1,0,4,1,3349,17,0.194386384,651
Region VII (Central Visayas),PH070000000,Cebu,PH072200000,City of Lapu-Lapu (Opon),PH072226000,98907,68615,26625,182,192,2414,29,22,108,135,98322,585,0.027318403,2686
Region VII (Central Visayas),PH070000000,Cebu,PH072200000,Liloan,PH072227000,27722,19012,7701,78,29,651,14,1,8,24,27518,204,0.025328876,697
Region VII (Central Visayas),PH070000000,Cebu,PH072200000,Madridejos,PH072228000,8063,4732,2599,147,32,447,30,1,16,22,8026,37,0.064166459,515
Region VII (Central Visayas),PH070000000,Cebu,PH072200000,Malabuyoc,PH072229000,3747,1056,1821,4,17,804,4,1,1,0,3708,39,0.218176915,809
Region VII (Central Visayas),PH070000000,Cebu,PH072200000,City of Mandaue,PH072230000,92557,53509,36831,400,35,603,73,6,60,241,91758,799,0.010647573,977
Region VII (Central Visayas),PH070000000,Cebu,PH072200000,Medellin,PH072231000,12669,6625,5468,100,11,211,6,6,155,50,12632,37,0.03340722,422
Region VII (Central Visayas),PH070000000,Cebu,PH072200000,Minglanilla,PH072232000,30127,23098,5673,124,61,797,12,2,30,36,29833,294,0.029329937,875
Region VII (Central Visayas),PH070000000,Cebu,PH072200000,Moalboal,PH072233000,7226,4203,2439,34,50,458,4,1,12,7,7208,18,0.06673141,481
Region VII (Central Visayas),PH070000000,Cebu,PH072200000,Oslob,PH072235000,5978,2786,2545,14,16,554,5,1,6,6,5933,45,0.096241362,571
Region VII (Central Visayas),PH070000000,Cebu,PH072200000,Pilar,PH072236000,2987,1504,1140,27,13,247,3,1,22,18,2975,12,0.097478992,290
Region VII (Central Visayas),PH070000000,Cebu,PH072200000,Pinamungahan,PH072237000,13824,7923,4768,46,57,969,12,0,8,10,13793,31,0.072428043,999
Region VII (Central Visayas),PH070000000,Cebu,PH072200000,Poro,PH072238000,6092,2928,2121,7,34,973,3,0,7,3,6076,16,0.162277814,986
Region VII (Central Visayas),PH070000000,Cebu,PH072200000,Ronda,PH072239000,4811,2492,1742,36,23,449,6,0,2,12,4762,49,0.09848803,469
Region VII (Central Visayas),PH070000000,Cebu,PH072200000,Samboan,PH072240000,4494,1808,1631,3,71,969,1,1,1,0,4485,9,0.216499443,971
Region VII (Central Visayas),PH070000000,Cebu,PH072200000,San Fernando,PH072241000,14223,8591,4432,30,49,1010,4,0,6,9,14131,92,0.072818626,1029
Region VII (Central Visayas),PH070000000,Cebu,PH072200000,San Francisco,PH072242000,12212,5685,3752,37,84,2440,40,5,52,35,12130,82,0.211624073,2567
Region VII (Central Visayas),PH070000000,Cebu,PH072200000,San Remigio,PH072243000,14397,8046,5450,182,13,345,11,24,217,67,14355,42,0.044583769,640
Region VII (Central Visayas),PH070000000,Cebu,PH072200000,Santa Fe,PH072244000,6719,3636,2476,103,34,348,26,8,23,37,6691,28,0.064863249,434
Region VII (Central Visayas),PH070000000,Cebu,PH072200000,Santander,PH072245000,4250,1969,1136,6,56,624,6,0,0,3,3800,450,0.166578947,633
Region VII (Central Visayas),PH070000000,Cebu,PH072200000,Sibonga,PH072246000,11185,4972,5343,88,37,613,13,2,24,15,11107,78,0.059872153,665
Region VII (Central Visayas),PH070000000,Cebu,PH072200000,Sogod,PH072247000,8416,4141,3631,33,8,491,4,0,0,3,8311,105,0.059920587,498
Region VII (Central Visayas),PH070000000,Cebu,PH072200000,Tabogon,PH072248000,9530,3719,5133,86,9,479,9,2,3,14,9454,76,0.053416543,505
Region VII (Central Visayas),PH070000000,Cebu,PH072200000,Tabuelan,PH072249000,6355,2688,2952,27,22,615,6,1,21,7,6339,16,0.102382079,649
Region VII (Central Visayas),PH070000000,Cebu,PH072200000,City of Toledo,PH072251000,37882,22403,11651,196,114,2804,57,97,274,127,37723,159,0.086472444,3262
Region VII (Central Visayas),PH070000000,Cebu,PH072200000,Tuburan,PH072252000,14974,4927,5550,18,142,4212,11,0,24,14,14898,76,0.286011545,4261
Region VII (Central Visayas),PH070000000,Cebu,PH072200000,Tudela,PH072253000,2757,1283,944,2,23,497,0,0,0,0,2749,8,0.180793016,497
Region VII (Central Visayas),PH070000000,Siquijor,PH076100000,Enrique Villanueva,PH076101000,1469,664,629,1,14,155,1,1,0,0,1465,4,0.106484642,156
Region VII (Central Visayas),PH070000000,Siquijor,PH076100000,Larena,PH076102000,3078,1563,1259,5,12,234,0,0,0,0,3073,5,0.076147088,234
Region VII (Central Visayas),PH070000000,Siquijor,PH076100000,Lazi,PH076103000,5001,2312,2239,22,4,403,3,0,2,10,4995,6,0.083683684,418
Region VII (Central Visayas),PH070000000,Siquijor,PH076100000,Maria,PH076104000,3152,1533,1273,4,13,322,2,0,0,3,3150,2,0.103809524,327
Region VII (Central Visayas),PH070000000,Siquijor,PH076100000,San Juan,PH076105000,3572,2266,830,4,69,398,1,0,0,0,3568,4,0.111827354,399
Region VII (Central Visayas),PH070000000,Siquijor,PH076100000,Siquijor (Capital),PH076106000,6362,4061,1675,20,56,472,11,1,2,4,6302,60,0.077594414,489
Region VIII (Eastern Visayas),PH080000000,Biliran,PH087800000,Almeria,PH087801000,4036,2214,1478,16,16,291,4,4,5,4,4032,4,0.075396825,304
Region VIII (Eastern Visayas),PH080000000,Biliran,PH087800000,Biliran,PH087802000,3825,1900,1547,45,9,290,12,1,2,9,3815,10,0.082044561,313
Region VIII (Eastern Visayas),PH080000000,Biliran,PH087800000,Cabucgayan,PH087803000,4715,2516,1497,14,39,640,5,0,0,2,4713,2,0.137279864,647
Region VIII (Eastern Visayas),PH080000000,Biliran,PH087800000,Caibiran,PH087804000,4767,2409,1701,44,33,539,18,0,7,8,4759,8,0.120193318,572
Region VIII (Eastern Visayas),PH080000000,Biliran,PH087800000,Culaba,PH087805000,2716,1329,898,2,40,440,5,1,0,0,2715,1,0.163904236,445
Region VIII (Eastern Visayas),PH080000000,Biliran,PH087800000,Kawayan,PH087806000,4607,2655,1217,63,49,522,50,2,11,14,4583,24,0.130264019,597
Region VIII (Eastern Visayas),PH080000000,Biliran,PH087800000,Maripipi,PH087807000,1661,724,321,1,57,552,5,0,0,1,1661,0,0.335942203,558
Region VIII (Eastern Visayas),PH080000000,Biliran,PH087800000,Naval (Capital),PH087808000,11778,6506,3878,43,104,1159,6,2,10,14,11722,56,0.101433203,1189
Region VIII (Eastern Visayas),PH080000000,Eastern Samar,PH082600000,Arteche,PH082601000,3494,825,660,1,70,1856,17,1,7,46,3483,11,0.552971576,1926
Region VIII (Eastern Visayas),PH080000000,Eastern Samar,PH082600000,Balangiga,PH082602000,3276,1075,1765,103,12,235,29,2,15,34,3270,6,0.095718654,313
Region VIII (Eastern Visayas),PH080000000,Eastern Samar,PH082600000,Balangkayan,PH082603000,2374,1004,1271,11,1,77,2,0,2,1,2369,5,0.034613761,82
Region VIII (Eastern Visayas),PH080000000,Eastern Samar,PH082600000,Can-Avid,PH082605000,4497,1883,1878,9,49,658,3,0,3,2,4485,12,0.148494983,666
Region VIII (Eastern Visayas),PH080000000,Eastern Samar,PH082600000,City of Borongan (Capital),PH082604000,15052,7525,5621,116,112,1526,50,14,40,30,15034,18,0.109485167,1646
Region VIII (Eastern Visayas),PH080000000,Eastern Samar,PH082600000,Dolores,PH082606000,9416,2737,4259,80,81,2013,58,5,44,79,9356,60,0.234501924,2194
Region VIII (Eastern Visayas),PH080000000,Eastern Samar,PH082600000,General Macarthur,PH082607000,2965,1105,1470,10,39,323,5,0,1,1,2954,11,0.111712932,330
Region VIII (Eastern Visayas),PH080000000,Eastern Samar,PH082600000,Giporlos,PH082608000,3209,915,2050,70,13,113,7,1,10,10,3189,20,0.043900909,140
Region VIII (Eastern Visayas),PH080000000,Eastern Samar,PH082600000,Guiuan,PH082609000,12394,4326,7515,179,22,261,18,3,14,37,12375,19,0.026666667,330
Region VIII (Eastern Visayas),PH080000000,Eastern Samar,PH082600000,Hernani,PH082610000,2052,581,1292,54,9,92,9,0,3,6,2046,6,0.053763441,110
Region VIII (Eastern Visayas),PH080000000,Eastern Samar,PH082600000,Jipapad,PH082611000,1721,220,783,6,4,682,4,0,2,1,1702,19,0.404817861,689
Region VIII (Eastern Visayas),PH080000000,Eastern Samar,PH082600000,Lawaan,PH082612000,3007,1203,1541,127,8,55,27,2,7,16,2986,21,0.035164099,105
Region VIII (Eastern Visayas),PH080000000,Eastern Samar,PH082600000,Llorente,PH082613000,4698,2010,1658,30,49,879,9,0,2,4,4641,57,0.192630899,894
Region VIII (Eastern Visayas),PH080000000,Eastern Samar,PH082600000,Maslog,PH082614000,1062,113,662,3,4,276,1,0,1,0,1060,2,0.262264151,278
Region VIII (Eastern Visayas),PH080000000,Eastern Samar,PH082600000,Maydolong,PH082615000,3224,1584,1279,52,10,251,11,0,2,20,3209,15,0.088501091,284
Region VIII (Eastern Visayas),PH080000000,Eastern Samar,PH082600000,Mercedes,PH082616000,1527,478,973,50,0,14,7,0,1,2,1525,2,0.015737705,24
Region VIII (Eastern Visayas),PH080000000,Eastern Samar,PH082600000,Oras,PH082617000,8455,2478,3177,140,120,2072,102,7,67,261,8424,31,0.297008547,2502
Region VIII (Eastern Visayas),PH080000000,Eastern Samar,PH082600000,Quinapondan,PH082618000,3377,1046,2176,14,9,109,7,0,5,7,3373,4,0.037948414,128
Region VIII (Eastern Visayas),PH080000000,Eastern Samar,PH082600000,Salcedo,PH082619000,5201,2077,2768,76,27,170,32,1,11,24,5186,15,0.045699961,237
Region VIII (Eastern Visayas),PH080000000,Eastern Samar,PH082600000,San Julian,PH082620000,3363,1437,1390,60,25,408,10,0,6,21,3357,6,0.132558832,445
Region VIII (Eastern Visayas),PH080000000,Eastern Samar,PH082600000,San Policarpo,PH082621000,3263,1119,692,32,87,1265,26,4,12,11,3248,15,0.40455665,1314
Region VIII (Eastern Visayas),PH080000000,Eastern Samar,PH082600000,Sulat,PH082622000,3650,1708,1499,12,34,371,2,1,5,7,3639,11,0.105798296,385
Region VIII (Eastern Visayas),PH080000000,Eastern Samar,PH082600000,Taft,PH082623000,4376,1774,1440,18,63,1030,16,3,7,14,4365,11,0.244444444,1067
Region VIII (Eastern Visayas),PH080000000,Leyte,PH083700000,Abuyog,PH083701000,13294,6573,4472,113,162,1814,73,4,12,15,13238,56,0.144583774,1914
Region VIII (Eastern Visayas),PH080000000,Leyte,PH083700000,Alangalang,PH083702000,12709,4913,6210,326,78,879,98,10,76,86,12676,33,0.089854844,1139
Region VIII (Eastern Visayas),PH080000000,Leyte,PH083700000,Albuera,PH083703000,11009,5308,3685,555,62,805,65,27,95,313,10915,94,0.117086578,1278
Region VIII (Eastern Visayas),PH080000000,Leyte,PH083700000,Babatngon,PH083705000,6047,2235,1815,137,124,1292,94,14,55,262,6028,19,0.28251493,1703
Region VIII (Eastern Visayas),PH080000000,Leyte,PH083700000,Barugo,PH083706000,6869,4524,1631,16,82,506,6,16,21,54,6856,13,0.085618436,587
Region VIII (Eastern Visayas),PH080000000,Leyte,PH083700000,Bato,PH083707000,8517,3652,3798,26,59,892,18,0,9,8,8462,55,0.10954857,927
Region VIII (Eastern Visayas),PH080000000,Leyte,PH083700000,Burauen,PH083710000,12521,4743,6174,168,73,1033,73,27,113,73,12477,44,0.103550533,1292
Region VIII (Eastern Visayas),PH080000000,Leyte,PH083700000,Calubian,PH083713000,7796,2569,4129,69,26,916,3,1,16,10,7739,57,0.1221088,945
Region VIII (Eastern Visayas),PH080000000,Leyte,PH083700000,Capoocan,PH083714000,7292,3333,2418,123,111,1092,28,1,11,27,7144,148,0.162094065,1158
Region VIII (Eastern Visayas),PH080000000,Leyte,PH083700000,Carigara,PH083715000,11230,6240,3831,60,85,916,8,3,19,48,11210,20,0.088403211,991
Region VIII (Eastern Visayas),PH080000000,Leyte,PH083700000,City of Baybay,PH083708000,25848,15395,8180,180,130,1642,22,11,35,33,25628,220,0.067582332,1732
Region VIII (Eastern Visayas),PH080000000,Leyte,PH083700000,Dagami,PH083717000,8374,2790,4976,140,15,274,11,8,32,33,8279,95,0.042275637,350
Region VIII (Eastern Visayas),PH080000000,Leyte,PH083700000,Dulag,PH083718000,11776,4544,5917,152,113,630,69,5,15,47,11492,284,0.066219979,761
Region VIII (Eastern Visayas),PH080000000,Leyte,PH083700000,Hilongos,PH083719000,14365,7346,4537,18,209,2129,14,4,5,13,14275,90,0.151383538,2161
Region VIII (Eastern Visayas),PH080000000,Leyte,PH083700000,Hindang,PH083720000,4989,3026,1045,16,74,786,4,1,8,10,4970,19,0.162575453,808
Region VIII (Eastern Visayas),PH080000000,Leyte,PH083700000,Inopacan,PH083721000,4900,3087,1375,0,35,365,1,1,0,0,4864,36,0.075246711,366
Region VIII (Eastern Visayas),PH080000000,Leyte,PH083700000,Isabel,PH083722000,11137,5388,4455,89,51,934,15,2,14,129,11077,60,0.098582649,1092
Region VIII (Eastern Visayas),PH080000000,Leyte,PH083700000,Jaro,PH083723000,9654,4314,3320,244,52,884,118,47,163,456,9598,56,0.168889352,1621
Region VIII (Eastern Visayas),PH080000000,Leyte,PH083700000,Javier (Bugho),PH083724000,5986,3010,2057,18,90,755,2,0,7,1,5940,46,0.128787879,765
Region VIII (Eastern Visayas),PH080000000,Leyte,PH083700000,Julita,PH083725000,3806,1059,2244,79,14,186,72,7,24,93,3778,28,0.099258867,375
Region VIII (Eastern Visayas),PH080000000,Leyte,PH083700000,Kananga,PH083726000,12784,5775,5522,389,74,599,94,10,31,97,12591,193,0.065205305,821
Region VIII (Eastern Visayas),PH080000000,Leyte,PH083700000,La Paz,PH083728000,4957,1513,2818,86,25,319,47,7,16,19,4850,107,0.082680412,401
Region VIII (Eastern Visayas),PH080000000,Leyte,PH083700000,Leyte,PH083729000,9011,2590,4867,150,67,1152,20,9,46,24,8925,86,0.139159664,1242
Region VIII (Eastern Visayas),PH080000000,Leyte,PH083700000,Macarthur,PH083730000,5077,2264,2302,146,33,236,26,6,22,21,5056,21,0.060324367,305
Region VIII (Eastern Visayas),PH080000000,Leyte,PH083700000,Mahaplag,PH083731000,6184,3492,1997,2,33,611,3,1,1,1,6141,43,0.100309396,616
Region VIII (Eastern Visayas),PH080000000,Leyte,PH083700000,Matag-Ob,PH083733000,4526,1740,2580,84,2,66,1,2,8,10,4493,33,0.018918317,85
Region VIII (Eastern Visayas),PH080000000,Leyte,PH083700000,Matalom,PH083734000,7496,3560,3276,14,20,567,5,2,10,6,7460,36,0.078820375,588
Region VIII (Eastern Visayas),PH080000000,Leyte,PH083700000,Mayorga,PH083735000,4224,1539,2233,96,42,212,32,4,19,36,4213,11,0.070970805,299
Region VIII (Eastern Visayas),PH080000000,Leyte,PH083700000,Merida,PH083736000,7802,2971,4189,161,12,366,11,3,17,11,7741,61,0.052318822,405
Region VIII (Eastern Visayas),PH080000000,Leyte,PH083700000,Ormoc City,PH083738000,49332,26308,17157,1324,290,2601,301,41,149,646,48817,515,0.075731815,3697
Region VIII (Eastern Visayas),PH080000000,Leyte,PH083700000,Palo,PH083739000,15584,7951,6776,72,84,364,32,5,16,24,15324,260,0.028452101,436
Region VIII (Eastern Visayas),PH080000000,Leyte,PH083700000,Palompon,PH083740000,14431,6271,7268,203,20,430,11,3,42,55,14303,128,0.037614486,538
Region VIII (Eastern Visayas),PH080000000,Leyte,PH083700000,Pastrana,PH083741000,4325,1194,2902,5,21,176,4,2,6,3,4313,12,0.043821006,189
Region VIII (Eastern Visayas),PH080000000,Leyte,PH083700000,San Isidro,PH083742000,7861,2367,4586,182,13,557,30,5,18,55,7813,48,0.084474594,660
Region VIII (Eastern Visayas),PH080000000,Leyte,PH083700000,San Miguel,PH083743000,4281,1745,1508,26,65,885,16,0,6,12,4263,18,0.215575886,919
Region VIII (Eastern Visayas),PH080000000,Leyte,PH083700000,Santa Fe,PH083744000,4720,1314,2801,329,11,149,25,1,22,18,4670,50,0.045824411,214
Region VIII (Eastern Visayas),PH080000000,Leyte,PH083700000,Tabango,PH083745000,8183,2224,4427,235,27,811,60,9,140,124,8057,126,0.140871292,1135
Region VIII (Eastern Visayas),PH080000000,Leyte,PH083700000,Tabontabon,PH083746000,2774,1713,916,23,11,82,5,2,3,10,2765,9,0.036166365,100
Region VIII (Eastern Visayas),PH080000000,Leyte,PH083700000,City of Tacloban (Capital),PH083747000,49541,28014,18165,1441,103,833,165,34,148,324,49227,314,0.029861661,1470
Region VIII (Eastern Visayas),PH080000000,Leyte,PH083700000,Tanauan,PH083748000,13370,5692,6533,343,62,579,52,5,18,30,13314,56,0.050998948,679
Region VIII (Eastern Visayas),PH080000000,Leyte,PH083700000,Tolosa,PH083749000,5032,2026,2668,182,8,53,18,4,6,36,5001,31,0.022595481,113
Region VIII (Eastern Visayas),PH080000000,Leyte,PH083700000,Tunga,PH083750000,1590,1047,435,13,11,66,2,1,4,9,1588,2,0.051007557,81
Region VIII (Eastern Visayas),PH080000000,Leyte,PH083700000,Villaba,PH083751000,10463,3950,6036,108,11,221,10,8,25,32,10401,62,0.027689645,288
Region VIII (Eastern Visayas),PH080000000,Northern Samar,PH084800000,Allen,PH084801000,5513,2317,380,7,424,2328,18,4,7,19,5504,9,0.430959302,2372
Region VIII (Eastern Visayas),PH080000000,Northern Samar,PH084800000,Biri,PH084802000,2262,646,49,6,294,1238,12,0,1,6,2252,10,0.558170515,1257
Region VIII (Eastern Visayas),PH080000000,Northern Samar,PH084800000,Bobon,PH084803000,4817,1530,908,59,172,2077,27,3,4,16,4796,21,0.442869058,2124
Region VIII (Eastern Visayas),PH080000000,Northern Samar,PH084800000,Capul,PH084804000,2486,941,231,1,241,1068,1,0,0,0,2483,3,0.430527588,1069
Region VIII (Eastern Visayas),PH080000000,Northern Samar,PH084800000,Catarman (Capital),PH084805000,18490,7863,3087,15,849,6539,50,8,8,11,18430,60,0.358545849,6608
Region VIII (Eastern Visayas),PH080000000,Northern Samar,PH084800000,Catubig,PH084806000,6442,2311,2057,27,88,1884,21,2,15,10,6415,27,0.300857366,1930
Region VIII (Eastern Visayas),PH080000000,Northern Samar,PH084800000,Gamay,PH084807000,5148,2088,911,3,185,1908,17,1,7,2,5122,26,0.37758688,1934
Region VIII (Eastern Visayas),PH080000000,Northern Samar,PH084800000,Laoang,PH084808000,12186,4014,1811,10,584,5680,44,2,9,14,12168,18,0.472304405,5747
Region VIII (Eastern Visayas),PH080000000,Northern Samar,PH084800000,Lapinig,PH084809000,2468,675,357,3,119,1278,13,0,3,7,2455,13,0.5299389,1301
Region VIII (Eastern Visayas),PH080000000,Northern Samar,PH084800000,Las Navas,PH084810000,7118,1116,4044,15,38,1806,13,3,33,35,7103,15,0.265662396,1887
Region VIII (Eastern Visayas),PH080000000,Northern Samar,PH084800000,Lavezares,PH084811000,6074,2138,580,1,366,2915,38,1,11,14,6064,10,0.491094987,2978
Region VIII (Eastern Visayas),PH080000000,Northern Samar,PH084800000,Lope De Vega,PH084824000,2808,729,821,0,20,1232,0,0,1,2,2805,3,0.440285205,1235
Region VIII (Eastern Visayas),PH080000000,Northern Samar,PH084800000,Mapanas,PH084812000,2781,1034,917,5,72,726,4,1,3,1,2763,18,0.265653275,734
Region VIII (Eastern Visayas),PH080000000,Northern Samar,PH084800000,Mondragon,PH084813000,7567,2378,1140,2,481,3461,2,2,0,2,7468,99,0.463979646,3465
Region VIII (Eastern Visayas),PH080000000,Northern Samar,PH084800000,Palapag,PH084814000,6900,3101,791,1,422,2568,5,0,3,1,6892,8,0.373911782,2577
Region VIII (Eastern Visayas),PH080000000,Northern Samar,PH084800000,Pambujan,PH084815000,5965,1630,857,0,370,3094,1,1,1,0,5954,11,0.519986564,3096
Region VIII (Eastern Visayas),PH080000000,Northern Samar,PH084800000,Rosario,PH084816000,2038,627,297,1,55,1041,3,1,2,3,2030,8,0.516748768,1049
Region VIII (Eastern Visayas),PH080000000,Northern Samar,PH084800000,San Antonio,PH084817000,1873,910,212,1,119,623,8,0,0,0,1873,0,0.336892686,631
Region VIII (Eastern Visayas),PH080000000,Northern Samar,PH084800000,San Isidro,PH084818000,5545,2772,660,1,375,1710,15,1,3,3,5540,5,0.312454874,1731
Region VIII (Eastern Visayas),PH080000000,Northern Samar,PH084800000,San Jose,PH084819000,3804,1140,860,3,103,1597,8,1,75,12,3799,5,0.445380363,1692
Region VIII (Eastern Visayas),PH080000000,Northern Samar,PH084800000,San Roque,PH084820000,5048,1925,688,1,290,2126,7,0,0,2,5039,9,0.423695178,2135
Region VIII (Eastern Visayas),PH080000000,Northern Samar,PH084800000,San Vicente,PH084821000,1641,591,252,17,82,638,34,2,0,15,1631,10,0.421213979,687
Region VIII (Eastern Visayas),PH080000000,Northern Samar,PH084800000,Silvino Lobos,PH084822000,2725,406,791,0,24,1480,5,0,2,8,2716,9,0.550441826,1495
Region VIII (Eastern Visayas),PH080000000,Northern Samar,PH084800000,Victoria,PH084823000,3210,1395,628,6,116,1043,10,1,5,1,3205,5,0.330421217,1059
Region VIII (Eastern Visayas),PH080000000,Samar (Western Samar),PH086000000,Almagro,PH086001000,2093,961,137,38,136,740,32,17,4,12,2077,16,0.379393356,788
Region VIII (Eastern Visayas),PH080000000,Samar (Western Samar),PH086000000,Basey,PH086002000,12623,3543,7181,174,66,1451,66,6,32,41,12560,63,0.126592357,1590
Region VIII (Eastern Visayas),PH080000000,Samar (Western Samar),PH086000000,City of Calbayog,PH086003000,37807,13403,8513,47,927,14464,134,14,213,47,37762,45,0.393464329,14858
Region VIII (Eastern Visayas),PH080000000,Samar (Western Samar),PH086000000,Calbiga,PH086004000,5092,1286,2322,2,49,1403,3,2,19,0,5086,6,0.280180889,1425
Region VIII (Eastern Visayas),PH080000000,Samar (Western Samar),PH086000000,City of Catbalogan (Capital),PH086005000,20602,10970,5929,289,218,2821,97,13,49,118,20504,98,0.150458447,3085
Region VIII (Eastern Visayas),PH080000000,Samar (Western Samar),PH086000000,Daram,PH086006000,8656,3089,2379,8,147,3000,13,0,2,4,8642,14,0.34934043,3019
Region VIII (Eastern Visayas),PH080000000,Samar (Western Samar),PH086000000,Gandara,PH086007000,7107,1841,1427,3,147,3671,6,1,5,3,7104,3,0.518721847,3685
Region VIII (Eastern Visayas),PH080000000,Samar (Western Samar),PH086000000,Hinabangan,PH086008000,2781,747,1372,31,24,566,22,0,6,4,2772,9,0.215728716,598
Region VIII (Eastern Visayas),PH080000000,Samar (Western Samar),PH086000000,Jiabong,PH086009000,3883,1186,1258,2,46,1382,4,0,1,0,3879,4,0.357566383,1387
Region VIII (Eastern Visayas),PH080000000,Samar (Western Samar),PH086000000,Marabut,PH086010000,3973,923,2751,30,14,212,17,1,11,7,3966,7,0.062279375,247
Region VIII (Eastern Visayas),PH080000000,Samar (Western Samar),PH086000000,Matuguinao,PH086011000,1441,126,641,1,5,666,0,0,2,0,1441,0,0.463566967,668
Region VIII (Eastern Visayas),PH080000000,Samar (Western Samar),PH086000000,Motiong,PH086012000,3040,896,1180,1,34,916,0,0,1,0,3028,12,0.302840159,917
Region VIII (Eastern Visayas),PH080000000,Samar (Western Samar),PH086000000,Pagsanghan,PH086026000,1814,679,123,0,95,915,1,0,1,0,1814,0,0.505512679,917
Region VIII (Eastern Visayas),PH080000000,Samar (Western Samar),PH086000000,Paranas (Wright),PH086022000,6294,2037,2920,4,37,1275,16,0,1,1,6291,3,0.205531712,1293
Region VIII (Eastern Visayas),PH080000000,Samar (Western Samar),PH086000000,Pinabacdao,PH086013000,3668,1003,1319,15,36,1268,3,0,3,6,3653,15,0.350396934,1280
Region VIII (Eastern Visayas),PH080000000,Samar (Western Samar),PH086000000,San Jorge,PH086025000,3450,885,1009,1,42,1487,2,1,5,7,3439,11,0.436464088,1501
Region VIII (Eastern Visayas),PH080000000,Samar (Western Samar),PH086000000,San Jose De Buan,PH086014000,1648,90,980,0,3,573,0,0,0,0,1646,2,0.348116646,573
Region VIII (Eastern Visayas),PH080000000,Samar (Western Samar),PH086000000,San Sebastian,PH086015000,1672,668,607,9,15,348,7,0,5,4,1663,9,0.218881539,364
Region VIII (Eastern Visayas),PH080000000,Samar (Western Samar),PH086000000,Santa Margarita,PH086016000,5611,1572,979,10,180,2819,21,5,8,2,5596,15,0.509292352,2850
Region VIII (Eastern Visayas),PH080000000,Samar (Western Samar),PH086000000,Santa Rita,PH086017000,8828,2160,2772,152,89,3516,34,6,34,40,8803,25,0.411677837,3624
Region VIII (Eastern Visayas),PH080000000,Samar (Western Samar),PH086000000,Santo Niño,PH086018000,2720,1110,386,1,188,1025,8,0,2,0,2720,0,0.380514706,1035
Region VIII (Eastern Visayas),PH080000000,Samar (Western Samar),PH086000000,Tagapul-An,PH086024000,1873,757,351,0,61,695,3,1,0,0,1868,5,0.37366167,698
Region VIII (Eastern Visayas),PH080000000,Samar (Western Samar),PH086000000,Talalora,PH086019000,1669,485,438,2,45,698,1,0,0,0,1669,0,0.418813661,699
Region VIII (Eastern Visayas),PH080000000,Samar (Western Samar),PH086000000,Tarangnan,PH086020000,5347,2158,633,19,216,2224,22,8,23,39,5342,5,0.432047922,2308
Region VIII (Eastern Visayas),PH080000000,Samar (Western Samar),PH086000000,Villareal,PH086021000,5943,1945,2094,55,56,1691,39,1,13,18,5912,31,0.297868742,1761
Region VIII (Eastern Visayas),PH080000000,Samar (Western Samar),PH086000000,Zumarraga,PH086023000,3251,1123,1173,0,58,890,0,0,3,0,3247,4,0.275023098,893
Region VIII (Eastern Visayas),PH080000000,Southern Leyte,PH086400000,Anahawan,PH086401000,1764,1087,372,26,16,213,11,13,12,14,1764,0,0.141723356,250
Region VIII (Eastern Visayas),PH080000000,Southern Leyte,PH086400000,Bontoc,PH086402000,6582,3798,2347,25,29,348,0,2,2,2,6553,29,0.053715855,352
Region VIII (Eastern Visayas),PH080000000,Southern Leyte,PH086400000,City of Maasin (Capital),PH086407000,18532,11157,5686,22,109,1480,12,5,17,3,18491,41,0.081769509,1512
Region VIII (Eastern Visayas),PH080000000,Southern Leyte,PH086400000,Hinunangan,PH086403000,6925,4103,1803,3,76,919,2,0,1,2,6909,16,0.133738602,924
Region VIII (Eastern Visayas),PH080000000,Southern Leyte,PH086400000,Hinundayan,PH086404000,3037,1797,479,1,99,656,3,0,0,0,3035,2,0.217133443,659
Region VIII (Eastern Visayas),PH080000000,Southern Leyte,PH086400000,Libagon,PH086405000,3162,1705,1028,8,22,360,5,1,9,1,3139,23,0.119464798,375
Region VIII (Eastern Visayas),PH080000000,Southern Leyte,PH086400000,Liloan,PH086406000,5073,3107,1063,5,66,812,9,1,2,1,5066,7,0.162652981,824
Region VIII (Eastern Visayas),PH080000000,Southern Leyte,PH086400000,Limasawa,PH086419000,1364,844,79,2,168,263,6,0,0,0,1362,2,0.197503671,269
Region VIII (Eastern Visayas),PH080000000,Southern Leyte,PH086400000,Macrohon,PH086408000,6031,3519,1985,1,37,472,1,0,3,1,6019,12,0.079249045,477
Region VIII (Eastern Visayas),PH080000000,Southern Leyte,PH086400000,Malitbog,PH086409000,4312,2541,1412,2,11,318,0,0,1,4,4289,23,0.07530893,323
Region VIII (Eastern Visayas),PH080000000,Southern Leyte,PH086400000,Padre Burgos,PH086410000,2386,1544,653,2,15,147,1,0,3,5,2370,16,0.065822785,156
Region VIII (Eastern Visayas),PH080000000,Southern Leyte,PH086400000,Pintuyan,PH086411000,2214,1180,592,4,84,350,1,0,1,1,2213,1,0.159511975,353
Region VIII (Eastern Visayas),PH080000000,Southern Leyte,PH086400000,Saint Bernard,PH086412000,5899,3497,1244,3,117,1010,3,0,5,1,5880,19,0.17329932,1019
Region VIII (Eastern Visayas),PH080000000,Southern Leyte,PH086400000,San Francisco,PH086413000,2960,1821,808,8,26,294,0,1,1,0,2959,1,0.099695843,295
Region VIII (Eastern Visayas),PH080000000,Southern Leyte,PH086400000,San Juan (Cabalian),PH086414000,3327,1916,733,0,38,625,0,0,1,0,3313,14,0.188952611,626
Region VIII (Eastern Visayas),PH080000000,Southern Leyte,PH086400000,San Ricardo,PH086415000,2196,1361,609,6,14,201,0,0,1,0,2192,4,0.092153285,202
Region VIII (Eastern Visayas),PH080000000,Southern Leyte,PH086400000,Silago,PH086416000,3096,1604,1246,2,8,235,0,0,0,0,3095,1,0.075928918,235
Region VIII (Eastern Visayas),PH080000000,Southern Leyte,PH086400000,Sogod,PH086417000,9899,6151,3319,19,21,300,2,1,18,2,9833,66,0.032746873,322
Region VIII (Eastern Visayas),PH080000000,Southern Leyte,PH086400000,Tomas Oppus,PH086418000,3646,1894,1525,5,11,195,0,0,1,0,3631,15,0.05397962,196
Region X (Northern Mindanao),PH100000000,Bukidnon,PH101300000,Baungon,PH101301000,7530,2126,5025,43,3,258,5,0,9,6,7475,55,0.037190635,278
Region X (Northern Mindanao),PH100000000,Bukidnon,PH101300000,Cabanglasan,PH101322000,6919,2185,4218,0,2,484,1,0,0,1,6891,28,0.070526774,486
Region X (Northern Mindanao),PH100000000,Bukidnon,PH101300000,City of Malaybalay (Capital),PH101312000,38440,20850,15071,104,34,1900,19,3,89,28,38098,342,0.053441126,2036
Region X (Northern Mindanao),PH100000000,Bukidnon,PH101300000,City of Valencia,PH101321000,43720,22982,18385,148,62,1661,16,3,22,12,43291,429,0.039523227,1711
Region X (Northern Mindanao),PH100000000,Bukidnon,PH101300000,Damulog,PH101302000,6718,1382,3473,1,3,1830,0,0,5,0,6694,24,0.274126083,1835
Region X (Northern Mindanao),PH100000000,Bukidnon,PH101300000,Dangcagan,PH101303000,5163,2436,2568,3,1,112,1,0,3,0,5124,39,0.022638564,116
Region X (Northern Mindanao),PH100000000,Bukidnon,PH101300000,Don Carlos,PH101304000,14296,6871,7052,37,1,171,1,1,12,2,14148,148,0.013146735,186
Region X (Northern Mindanao),PH100000000,Bukidnon,PH101300000,Impasug-Ong,PH101305000,9734,3491,5473,10,6,526,4,0,58,0,9568,166,0.061454849,588
Region X (Northern Mindanao),PH100000000,Bukidnon,PH101300000,Kadingilan,PH101306000,7437,2396,4717,2,5,251,1,2,46,0,7420,17,0.040161725,298
Region X (Northern Mindanao),PH100000000,Bukidnon,PH101300000,Kalilangan,PH101307000,8733,2813,5609,10,1,250,0,0,4,2,8689,44,0.029462539,256
Region X (Northern Mindanao),PH100000000,Bukidnon,PH101300000,Kibawe,PH101308000,8825,3226,4715,1,5,844,0,2,6,0,8799,26,0.096601887,850
Region X (Northern Mindanao),PH100000000,Bukidnon,PH101300000,Kitaotao,PH101309000,10874,2575,6170,7,20,2062,0,1,1,2,10838,36,0.190533309,2065
Region X (Northern Mindanao),PH100000000,Bukidnon,PH101300000,Lantapan,PH101310000,12767,5069,7122,6,6,428,6,0,42,0,12679,88,0.037542393,476
Region X (Northern Mindanao),PH100000000,Bukidnon,PH101300000,Libona,PH101311000,9919,3234,6182,39,4,341,7,1,47,18,9873,46,0.041831257,413
Region X (Northern Mindanao),PH100000000,Bukidnon,PH101300000,Malitbog,PH101313000,4974,1228,3265,3,3,454,0,0,3,0,4956,18,0.092211461,457
Region X (Northern Mindanao),PH100000000,Bukidnon,PH101300000,Manolo Fortich,PH101314000,21135,10064,9793,61,34,831,6,4,87,39,20919,216,0.046034705,963
Region X (Northern Mindanao),PH100000000,Bukidnon,PH101300000,Maramag,PH101315000,22712,11964,9828,72,7,515,9,0,18,18,22431,281,0.02496545,560
Region X (Northern Mindanao),PH100000000,Bukidnon,PH101300000,Pangantucan,PH101316000,11326,3857,7157,11,3,237,1,0,4,2,11272,54,0.021646558,244
Region X (Northern Mindanao),PH100000000,Bukidnon,PH101300000,Quezon,PH101317000,22903,9334,12327,16,2,994,3,0,38,2,22716,187,0.045650643,1037
Region X (Northern Mindanao),PH100000000,Bukidnon,PH101300000,San Fernando,PH101318000,12312,2564,7384,15,6,2192,23,0,86,8,12278,34,0.188059945,2309
Region X (Northern Mindanao),PH100000000,Bukidnon,PH101300000,Sumilao,PH101319000,5546,2774,2463,7,2,169,1,0,27,4,5447,99,0.036901046,201
Region X (Northern Mindanao),PH100000000,Bukidnon,PH101300000,Talakag,PH101320000,14012,2753,10531,32,6,507,21,0,18,23,13891,121,0.040961774,569
Region X (Northern Mindanao),PH100000000,Camiguin,PH101800000,Catarman,PH101801000,4060,2204,1638,0,7,202,1,0,6,0,4058,2,0.051503204,209
Region X (Northern Mindanao),PH100000000,Camiguin,PH101800000,Guinsiliban,PH101802000,1452,524,692,0,3,225,0,0,0,0,1444,8,0.155817175,225
Region X (Northern Mindanao),PH100000000,Camiguin,PH101800000,Mahinog,PH101803000,3134,1690,1216,3,7,191,1,0,1,1,3110,24,0.062379421,194
Region X (Northern Mindanao),PH100000000,Camiguin,PH101800000,Mambajao (Capital),PH101804000,8542,5620,2682,2,6,174,0,1,0,2,8487,55,0.020737599,176
Region X (Northern Mindanao),PH100000000,Camiguin,PH101800000,Sagay,PH101805000,2875,1021,1271,2,22,529,1,0,2,0,2848,27,0.186797753,532
Region X (Northern Mindanao),PH100000000,Lanao Del Norte,PH103500000,Bacolod,PH103501000,5104,1471,2749,1,11,849,2,0,10,8,5101,3,0.170358753,869
Region X (Northern Mindanao),PH100000000,Lanao Del Norte,PH103500000,Baloi,PH103502000,6946,2679,4126,0,6,117,1,1,4,3,6937,9,0.018019317,125
Region X (Northern Mindanao),PH100000000,Lanao Del Norte,PH103500000,Baroy,PH103503000,5528,2620,1663,6,105,1112,12,0,0,0,5518,10,0.203696992,1124
Region X (Northern Mindanao),PH100000000,Lanao Del Norte,PH103500000,City of Iligan,PH103504000,74647,43754,26258,124,86,4036,19,7,85,105,74474,173,0.056999758,4245
Region X (Northern Mindanao),PH100000000,Lanao Del Norte,PH103500000,Kapatagan,PH103505000,13416,5119,3717,6,342,4072,24,3,9,7,13299,117,0.30919618,4112
Region X (Northern Mindanao),PH100000000,Lanao Del Norte,PH103500000,Kauswagan,PH103507000,5255,1885,2654,6,27,663,8,1,8,3,5255,0,0.129781161,682
Region X (Northern Mindanao),PH100000000,Lanao Del Norte,PH103500000,Kolambugan,PH103508000,6197,2180,1921,2,93,1994,5,0,1,1,6197,0,0.322898177,2001
Region X (Northern Mindanao),PH100000000,Lanao Del Norte,PH103500000,Lala,PH103509000,15051,7575,2814,17,486,4066,52,4,9,9,15032,19,0.275146354,4136
Region X (Northern Mindanao),PH100000000,Lanao Del Norte,PH103500000,Linamon,PH103510000,4195,2033,1830,2,14,311,1,0,1,1,4193,2,0.074886716,314
Region X (Northern Mindanao),PH100000000,Lanao Del Norte,PH103500000,Magsaysay,PH103511000,3833,660,1264,0,40,1815,0,0,5,49,3833,0,0.487607618,1869
Region X (Northern Mindanao),PH100000000,Lanao Del Norte,PH103500000,Maigo,PH103512000,4781,1763,1673,3,100,1230,3,1,7,1,4781,0,0.259569128,1241
Region X (Northern Mindanao),PH100000000,Lanao Del Norte,PH103500000,Matungao,PH103513000,1541,386,1119,0,0,36,0,0,0,0,1541,0,0.023361454,36
Region X (Northern Mindanao),PH100000000,Lanao Del Norte,PH103500000,Munai,PH103514000,4893,390,3777,0,31,524,0,4,162,0,4888,5,0.140343699,686
Region X (Northern Mindanao),PH100000000,Lanao Del Norte,PH103500000,Nunungan,PH103515000,3456,666,1735,0,21,1017,10,0,0,0,3449,7,0.297767469,1027
Region X (Northern Mindanao),PH100000000,Lanao Del Norte,PH103500000,Pantao Ragat,PH103516000,2335,635,1454,0,2,189,0,0,0,2,2282,53,0.08369851,191
Region X (Northern Mindanao),PH100000000,Lanao Del Norte,PH103500000,Pantar,PH103523000,2623,653,1611,0,8,348,0,0,2,1,2623,0,0.133816241,351
Region X (Northern Mindanao),PH100000000,Lanao Del Norte,PH103500000,Poona Piagapo,PH103517000,3648,387,3161,0,0,89,1,0,2,0,3640,8,0.025274725,92
Region X (Northern Mindanao),PH100000000,Lanao Del Norte,PH103500000,Salvador,PH103518000,6830,2555,1308,0,138,2806,3,0,1,4,6815,15,0.412912693,2814
Region X (Northern Mindanao),PH100000000,Lanao Del Norte,PH103500000,Sapad,PH103519000,4354,1364,1226,11,86,1653,12,0,0,0,4352,2,0.382582721,1665
Region X (Northern Mindanao),PH100000000,Lanao Del Norte,PH103500000,Sultan Naga Dimaporo (Karomatan),PH103506000,11422,2624,4981,7,70,3682,14,2,7,15,11402,20,0.326083143,3718
Region X (Northern Mindanao),PH100000000,Lanao Del Norte,PH103500000,Tagoloan,PH103520000,2546,194,2150,0,11,140,0,0,2,0,2497,49,0.056868242,142
Region X (Northern Mindanao),PH100000000,Lanao Del Norte,PH103500000,Tangcal,PH103521000,2227,217,1694,0,4,312,0,0,0,0,2227,0,0.140098788,312
Region X (Northern Mindanao),PH100000000,Lanao Del Norte,PH103500000,Tubod (Capital),PH103522000,10949,3942,4298,1,103,2596,3,0,0,0,10943,6,0.237503427,2599
Region X (Northern Mindanao),PH100000000,Misamis Occidental,PH104200000,Aloran,PH104201000,6313,2854,1644,16,146,1637,4,0,1,1,6303,10,0.260669522,1643
Region X (Northern Mindanao),PH100000000,Misamis Occidental,PH104200000,Baliangao,PH104202000,3841,1009,897,10,86,1824,8,0,2,0,3836,5,0.47810219,1834
Region X (Northern Mindanao),PH100000000,Misamis Occidental,PH104200000,Bonifacio,PH104203000,7201,1726,3013,2,60,2376,2,0,1,0,7180,21,0.331337047,2379
Region X (Northern Mindanao),PH100000000,Misamis Occidental,PH104200000,Calamba,PH104204000,4937,2011,1788,1,25,1095,1,0,0,1,4922,15,0.222876879,1097
Region X (Northern Mindanao),PH100000000,Misamis Occidental,PH104200000,Clarin,PH104205000,8293,3825,2843,5,55,1524,4,0,6,1,8263,30,0.185767881,1535
Region X (Northern Mindanao),PH100000000,Misamis Occidental,PH104200000,Concepcion,PH104206000,2457,86,1285,0,7,1077,0,0,0,1,2456,1,0.438925081,1078
Region X (Northern Mindanao),PH100000000,Misamis Occidental,PH104200000,Don Victoriano Chiongbian  (Don Mariano Marcos),PH104217000,2479,318,1778,4,3,357,1,0,4,9,2474,5,0.14995958,371
Region X (Northern Mindanao),PH100000000,Misamis Occidental,PH104200000,Jimenez,PH104207000,6307,3241,1859,0,65,1130,0,0,1,0,6296,11,0.179637865,1131
Region X (Northern Mindanao),PH100000000,Misamis Occidental,PH104200000,Lopez Jaena,PH104208000,5803,1842,2150,1,65,1711,2,0,3,0,5774,29,0.297194319,1716
Region X (Northern Mindanao),PH100000000,Misamis Occidental,PH104200000,City of Oroquieta (Capital),PH104209000,16340,7759,5346,8,259,2900,6,1,20,6,16305,35,0.17982214,2932
Region X (Northern Mindanao),PH100000000,Misamis Occidental,PH104200000,City of Ozamiz,PH104210000,29626,12769,13905,29,52,2740,31,5,29,16,29576,50,0.095212334,2816
Region X (Northern Mindanao),PH100000000,Misamis Occidental,PH104200000,Panaon,PH104211000,2406,1114,760,2,21,500,1,0,0,0,2398,8,0.208924103,501
Region X (Northern Mindanao),PH100000000,Misamis Occidental,PH104200000,Plaridel,PH104212000,9151,3593,1435,14,485,3583,10,2,11,4,9137,14,0.394877969,3608
Region X (Northern Mindanao),PH100000000,Misamis Occidental,PH104200000,Sapang Dalaga,PH104213000,4545,1032,1740,1,20,1730,10,0,8,3,4544,1,0.38534331,1751
Region X (Northern Mindanao),PH100000000,Misamis Occidental,PH104200000,Sinacaban,PH104214000,4088,1603,1627,18,25,744,16,1,13,24,4071,17,0.195774994,797
Region X (Northern Mindanao),PH100000000,Misamis Occidental,PH104200000,City of Tangub,PH104215000,12868,4543,5258,12,67,2959,5,3,0,0,12847,21,0.230715342,2964
Region X (Northern Mindanao),PH100000000,Misamis Occidental,PH104200000,Tudela,PH104216000,6468,2621,2331,1,47,1455,6,0,1,1,6463,5,0.226365465,1463
Region X (Northern Mindanao),PH100000000,Misamis Oriental,PH104300000,Alubijid,PH104301000,7627,2474,3024,14,54,1971,7,0,4,0,7548,79,0.262586116,1982
Region X (Northern Mindanao),PH100000000,Misamis Oriental,PH104300000,Balingasag,PH104302000,14514,6802,5360,12,63,2154,8,0,12,7,14418,96,0.151269247,2181
Region X (Northern Mindanao),PH100000000,Misamis Oriental,PH104300000,Balingoan,PH104303000,2243,931,1153,12,5,121,3,1,0,0,2226,17,0.055705301,124
Region X (Northern Mindanao),PH100000000,Misamis Oriental,PH104300000,Binuangan,PH104304000,1523,669,717,1,0,120,2,1,3,5,1518,5,0.085638999,130
Region X (Northern Mindanao),PH100000000,Misamis Oriental,PH104300000,City of Cagayan De Oro (Capital),PH104305000,158021,107820,45558,281,140,3004,44,19,152,96,157114,907,0.020978398,3296
Region X (Northern Mindanao),PH100000000,Misamis Oriental,PH104300000,City of El Salvador,PH104307000,11769,5093,3879,14,81,2590,12,1,11,8,11689,80,0.224227907,2621
Region X (Northern Mindanao),PH100000000,Misamis Oriental,PH104300000,Claveria,PH104306000,10985,3034,6808,14,12,989,4,1,9,4,10875,110,0.092505747,1006
Region X (Northern Mindanao),PH100000000,Misamis Oriental,PH104300000,City of Gingoog,PH104308000,26307,9692,13039,119,86,3023,65,4,34,39,26101,206,0.121106471,3161
Region X (Northern Mindanao),PH100000000,Misamis Oriental,PH104300000,Gitagum,PH104309000,3852,1585,1480,5,12,752,0,0,1,0,3835,17,0.196349413,753
Region X (Northern Mindanao),PH100000000,Misamis Oriental,PH104300000,Initao,PH104310000,7361,2891,3174,7,28,1201,2,1,9,6,7319,42,0.166416177,1218
Region X (Northern Mindanao),PH100000000,Misamis Oriental,PH104300000,Jasaan,PH104311000,11933,6092,4681,14,19,1030,0,2,18,3,11859,74,0.088624673,1051
Region X (Northern Mindanao),PH100000000,Misamis Oriental,PH104300000,Kinoguitan,PH104312000,2984,1052,1324,0,19,584,0,0,2,0,2981,3,0.196578329,586
Region X (Northern Mindanao),PH100000000,Misamis Oriental,PH104300000,Lagonglong,PH104313000,4474,1975,1514,1,25,887,3,0,5,4,4414,60,0.20367014,899
Region X (Northern Mindanao),PH100000000,Misamis Oriental,PH104300000,Laguindingan,PH104314000,5604,2864,2096,1,18,585,1,0,0,0,5565,39,0.105300988,586
Region X (Northern Mindanao),PH100000000,Misamis Oriental,PH104300000,Libertad,PH104315000,2707,1143,1051,1,22,460,4,0,0,0,2681,26,0.17306975,464
Region X (Northern Mindanao),PH100000000,Misamis Oriental,PH104300000,Lugait,PH104316000,4372,2051,2039,16,10,224,2,0,1,1,4344,28,0.052486188,228
Region X (Northern Mindanao),PH100000000,Misamis Oriental,PH104300000,Magsaysay (Linugos),PH104317000,6970,2133,2539,69,80,2043,22,1,23,33,6943,27,0.305487541,2121
Region X (Northern Mindanao),PH100000000,Misamis Oriental,PH104300000,Manticao,PH104318000,6384,2545,3162,14,12,588,5,0,1,3,6330,54,0.094312796,597
Region X (Northern Mindanao),PH100000000,Misamis Oriental,PH104300000,Medina,PH104319000,7060,3317,3088,26,14,556,6,1,6,3,7017,43,0.081373806,571
Region X (Northern Mindanao),PH100000000,Misamis Oriental,PH104300000,Naawan,PH104320000,4663,1806,1853,6,6,720,0,4,152,94,4641,22,0.208144796,966
Region X (Northern Mindanao),PH100000000,Misamis Oriental,PH104300000,Opol,PH104321000,13978,8023,4055,4,44,1772,2,2,6,4,13912,66,0.128234618,1784
Region X (Northern Mindanao),PH100000000,Misamis Oriental,PH104300000,Salay,PH104322000,6141,2454,2728,1,15,907,1,0,2,2,6110,31,0.149263502,912
Region X (Northern Mindanao),PH100000000,Misamis Oriental,PH104300000,Sugbongcogon,PH104323000,1895,771,1083,0,2,36,0,0,1,0,1893,2,0.019545695,37
Region X (Northern Mindanao),PH100000000,Misamis Oriental,PH104300000,Tagoloan,PH104324000,16661,7759,8137,36,12,580,2,1,29,27,16583,78,0.038473135,638
Region X (Northern Mindanao),PH100000000,Misamis Oriental,PH104300000,Talisayan,PH104325000,5310,2125,2638,37,14,457,10,1,4,11,5297,13,0.090994903,482
Region X (Northern Mindanao),PH100000000,Misamis Oriental,PH104300000,Villanueva,PH104326000,8518,4888,3008,7,17,534,2,0,12,12,8480,38,0.066037736,560
Region XI (Davao Region),PH110000000,Compostela Valley,PH118200000,Compostela,PH118201000,18791,8678,8592,107,59,1167,5,1,13,19,18641,150,0.06458881,1204
Region XI (Davao Region),PH110000000,Compostela Valley,PH118200000,Laak (San Vicente),PH118202000,17401,4992,10019,41,13,2158,14,2,50,22,17311,90,0.12962856,2244
Region XI (Davao Region),PH110000000,Compostela Valley,PH118200000,Mabini (Doña Alicia),PH118203000,9618,3871,3421,0,96,2164,1,1,1,0,9555,63,0.226687598,2166
Region XI (Davao Region),PH110000000,Compostela Valley,PH118200000,Maco,PH118204000,18666,8308,8650,8,21,1386,2,1,9,3,18388,278,0.076136611,1400
Region XI (Davao Region),PH110000000,Compostela Valley,PH118200000,Maragusan (San Mariano),PH118205000,14022,6658,5799,4,30,1278,2,3,60,10,13844,178,0.097515169,1350
Region XI (Davao Region),PH110000000,Compostela Valley,PH118200000,Mawab,PH118206000,8272,4239,3572,8,20,304,3,1,8,2,8157,115,0.038862327,317
Region XI (Davao Region),PH110000000,Compostela Valley,PH118200000,Monkayo,PH118207000,21308,7972,11024,585,11,793,69,5,55,122,20636,672,0.050348905,1039
Region XI (Davao Region),PH110000000,Compostela Valley,PH118200000,Montevista,PH118208000,9933,4128,5281,30,9,411,1,0,10,3,9873,60,0.043046693,425
Region XI (Davao Region),PH110000000,Compostela Valley,PH118200000,Nabunturan (Capital),PH118209000,18810,9284,8457,24,40,749,4,0,5,6,18569,241,0.041143842,764
Region XI (Davao Region),PH110000000,Compostela Valley,PH118200000,New Bataan,PH118210000,11579,6023,5094,16,11,299,11,1,49,31,11535,44,0.033810143,390
Region XI (Davao Region),PH110000000,Compostela Valley,PH118200000,Pantukan,PH118211000,19132,6726,7444,119,214,4381,58,2,13,3,18960,172,0.234968354,4455
Region XI (Davao Region),PH110000000,Davao Del Norte,PH112300000,Asuncion (Saug),PH112301000,13700,5118,6329,6,40,2035,2,0,19,7,13556,144,0.152183535,2063
Region XI (Davao Region),PH110000000,Davao Del Norte,PH112300000,Braulio E. Dujali,PH112323000,5367,2661,1994,9,16,639,1,0,3,0,5323,44,0.120796543,643
Region XI (Davao Region),PH110000000,Davao Del Norte,PH112300000,Carmen,PH112303000,16611,7847,6177,19,62,2333,15,2,6,15,16476,135,0.143784899,2369
Region XI (Davao Region),PH110000000,Davao Del Norte,PH112300000,City of Panabo,PH112315000,41965,26374,12313,22,162,2704,7,1,13,15,41611,354,0.065823941,2739
Region XI (Davao Region),PH110000000,Davao Del Norte,PH112300000,City of Tagum (Capital),PH112319000,59296,38506,16456,31,183,3605,6,10,13,5,58815,481,0.061701947,3629
Region XI (Davao Region),PH110000000,Davao Del Norte,PH112300000,Island Garden City of Samal,PH112317000,25523,8737,14049,39,19,1977,4,5,187,45,25062,461,0.088301013,2213
Region XI (Davao Region),PH110000000,Davao Del Norte,PH112300000,Kapalong,PH112305000,17150,7076,6497,14,55,3344,3,5,79,4,17077,73,0.200854951,3430
Region XI (Davao Region),PH110000000,Davao Del Norte,PH112300000,New Corella,PH112314000,12367,4946,6310,1,9,1036,0,0,0,0,12302,65,0.084213949,1036
Region XI (Davao Region),PH110000000,Davao Del Norte,PH112300000,San Isidro,PH112324000,6363,1602,4409,10,0,240,0,0,4,3,6268,95,0.039406509,247
Region XI (Davao Region),PH110000000,Davao Del Norte,PH112300000,Santo Tomas,PH112318000,26041,15521,8256,18,73,1903,5,1,8,8,25793,248,0.074593882,1924
Region XI (Davao Region),PH110000000,Davao Del Norte,PH112300000,Talaingod,PH112322000,6137,734,2350,3,12,3013,10,1,0,0,6123,14,0.493712233,3023
Region XI (Davao Region),PH110000000,Davao Del Sur,PH112400000,Bansalan,PH112401000,14826,7887,6404,34,7,359,3,0,12,4,14710,116,0.025696805,378
Region XI (Davao Region),PH110000000,Davao Del Sur,PH112400000,City of Digos (Capital),PH112403000,41299,24090,13809,69,181,2455,24,29,78,21,40756,543,0.06325449,2578
Region XI (Davao Region),PH110000000,Davao Del Sur,PH112400000,City of Davao,PH112402000,400675,243070,138337,913,622,10961,151,59,223,388,394724,5951,0.029699233,11723
Region XI (Davao Region),PH110000000,Davao Del Sur,PH112400000,Hagonoy,PH112404000,12996,5871,4832,7,79,2007,6,2,9,2,12815,181,0.157939914,2024
Region XI (Davao Region),PH110000000,Davao Del Sur,PH112400000,Kiblawan,PH112406000,13425,2203,6556,0,36,4543,0,1,3,0,13342,83,0.340728526,4546
Region XI (Davao Region),PH110000000,Davao Del Sur,PH112400000,Magsaysay,PH112407000,13472,5195,5624,5,41,2436,10,0,4,0,13315,157,0.184003004,2450
Region XI (Davao Region),PH110000000,Davao Del Sur,PH112400000,Malalag,PH112408000,10025,2985,4365,2,36,2552,3,0,0,1,9944,81,0.257039421,2556
Region XI (Davao Region),PH110000000,Davao Del Sur,PH112400000,Matanao,PH112410000,13787,5498,5016,3,88,3114,5,1,4,4,13733,54,0.227699701,3127
Region XI (Davao Region),PH110000000,Davao Del Sur,PH112400000,Padada,PH112411000,6869,3268,2429,4,51,1040,1,1,1,0,6795,74,0.15334805,1042
Region XI (Davao Region),PH110000000,Davao Del Sur,PH112400000,Santa Cruz,PH112412000,22167,9364,9720,80,81,2510,13,0,9,28,21805,362,0.117404265,2560
Region XI (Davao Region),PH110000000,Davao Del Sur,PH112400000,Sulop,PH112414000,8550,2537,4009,3,37,1859,3,0,0,0,8448,102,0.220407197,1862
Region XI (Davao Region),PH110000000,Davao Occidental,PH118600000,Don Marcelino,PH118601000,11191,1214,979,0,268,8596,2,1,1,12,11073,118,0.777657365,8611
Region XI (Davao Region),PH110000000,Davao Occidental,PH118600000,Jose Abad Santos (Trinidad),PH118602000,17990,1689,391,0,754,15111,10,0,0,7,17962,28,0.84222247,15128
Region XI (Davao Region),PH110000000,Davao Occidental,PH118600000,Malita (Capital),PH118603000,28204,5306,5674,22,425,16457,9,12,9,30,27944,260,0.590645577,16505
Region XI (Davao Region),PH110000000,Davao Occidental,PH118600000,Santa Maria,PH118604000,13590,2865,3502,1,189,6909,4,0,14,4,13488,102,0.513864176,6931
Region XI (Davao Region),PH110000000,Davao Occidental,PH118600000,Sarangani,PH118605000,5632,1264,1507,0,41,2640,1,0,2,2,5457,175,0.484698552,2645
Region XI (Davao Region),PH110000000,Davao Oriental,PH112500000,Baganga,PH112501000,13259,5935,6166,96,23,843,22,5,46,87,13223,36,0.075474552,998
Region XI (Davao Region),PH110000000,Davao Oriental,PH112500000,Banaybanay,PH112502000,9251,3737,2539,8,198,2701,9,0,6,4,9202,49,0.295587916,2720
Region XI (Davao Region),PH110000000,Davao Oriental,PH112500000,Boston,PH112503000,3212,1375,1602,15,10,187,1,1,7,1,3199,13,0.061269147,196
Region XI (Davao Region),PH110000000,Davao Oriental,PH112500000,Caraga,PH112504000,9094,1525,2838,2,121,4528,8,0,49,2,9073,21,0.505565965,4587
Region XI (Davao Region),PH110000000,Davao Oriental,PH112500000,Cateel,PH112505000,9694,4301,4070,47,28,973,20,45,122,14,9620,74,0.117359667,1129
Region XI (Davao Region),PH110000000,Davao Oriental,PH112500000,City of Mati (Capital),PH112509000,31853,10475,14008,137,195,6205,50,3,58,109,31240,613,0.205569782,6422
Region XI (Davao Region),PH110000000,Davao Oriental,PH112500000,Governor Generoso,PH112506000,12448,4596,3754,15,189,3749,13,1,3,3,12323,125,0.305769699,3768
Region XI (Davao Region),PH110000000,Davao Oriental,PH112500000,Lupon,PH112507000,15210,5129,5914,2,261,3751,1,0,1,0,15059,151,0.249219736,3753
Region XI (Davao Region),PH110000000,Davao Oriental,PH112500000,Manay,PH112508000,9528,1664,1510,1,111,6192,1,0,16,0,9495,33,0.653923117,6209
Region XI (Davao Region),PH110000000,Davao Oriental,PH112500000,San Isidro,PH112510000,7788,2705,3316,3,73,1595,2,0,2,0,7696,92,0.20777027,1599
Region XI (Davao Region),PH110000000,Davao Oriental,PH112500000,Tarragona,PH112511000,5632,978,2030,0,57,2346,1,0,3,8,5423,209,0.434814678,2358
Region XII (SOCCSKSARGEN),PH120000000,Cotabato City (Not a Province),PH129800000,City of Cotabato,PH129804000,55987,25894,22730,68,200,6359,24,7,236,335,55853,134,0.124505398,6954
Region XII (SOCCSKSARGEN),PH120000000,Cotabato (North Cotabato),PH124700000,Alamada,PH124701000,14481,3164,9750,21,19,1451,2,1,1,2,14411,70,0.101033932,1456
Region XII (SOCCSKSARGEN),PH120000000,Cotabato (North Cotabato),PH124700000,Aleosan,PH124717000,8803,2062,4919,5,21,1775,0,0,1,0,8783,20,0.202208812,1776
Region XII (SOCCSKSARGEN),PH120000000,Cotabato (North Cotabato),PH124700000,Antipas,PH124715000,6063,2612,2958,5,11,454,2,0,3,0,6045,18,0.075930521,459
Region XII (SOCCSKSARGEN),PH120000000,Cotabato (North Cotabato),PH124700000,Arakan,PH124718000,10656,2095,6365,37,9,2045,21,0,3,1,10576,80,0.195726172,2070
Region XII (SOCCSKSARGEN),PH120000000,Cotabato (North Cotabato),PH124700000,Banisilan,PH124716000,9625,2366,6449,8,16,742,2,0,1,2,9586,39,0.077926142,747
Region XII (SOCCSKSARGEN),PH120000000,Cotabato (North Cotabato),PH124700000,Carmen,PH124702000,21810,5082,10336,9,83,6188,27,1,14,13,21753,57,0.286948927,6242
Region XII (SOCCSKSARGEN),PH120000000,Cotabato (North Cotabato),PH124700000,City of Kidapawan (Capital),PH124704000,32921,19272,12346,35,15,944,5,0,16,15,32648,273,0.030017153,980
Region XII (SOCCSKSARGEN),PH120000000,Cotabato (North Cotabato),PH124700000,Kabacan,PH124703000,19641,10298,5646,9,41,3547,1,0,1,0,19543,98,0.18159955,3549
Region XII (SOCCSKSARGEN),PH120000000,Cotabato (North Cotabato),PH124700000,Libungan,PH124705000,11446,4823,5499,19,20,1035,9,0,4,0,11409,37,0.091857306,1048
Region XII (SOCCSKSARGEN),PH120000000,Cotabato (North Cotabato),PH124700000,Magpet,PH124706000,11084,3808,6611,53,0,578,2,0,4,1,11057,27,0.05290766,585
Region XII (SOCCSKSARGEN),PH120000000,Cotabato (North Cotabato),PH124700000,Makilala,PH124707000,19170,9254,9135,3,6,587,0,0,10,0,18995,175,0.031429324,597
Region XII (SOCCSKSARGEN),PH120000000,Cotabato (North Cotabato),PH124700000,Matalam,PH124708000,18693,7568,8452,36,28,2459,9,1,4,12,18569,124,0.133771339,2484
Region XII (SOCCSKSARGEN),PH120000000,Cotabato (North Cotabato),PH124700000,Midsayap,PH124709000,33698,15395,12259,44,265,5061,11,8,52,376,33471,227,0.164321353,5500
Region XII (SOCCSKSARGEN),PH120000000,Cotabato (North Cotabato),PH124700000,M'Lang,PH124710000,23008,10404,8815,26,233,3328,8,1,20,5,22840,168,0.147154116,3361
Region XII (SOCCSKSARGEN),PH120000000,Cotabato (North Cotabato),PH124700000,Pigkawayan,PH124711000,15201,6447,6337,6,110,2195,1,0,9,17,15122,79,0.146938236,2222
Region XII (SOCCSKSARGEN),PH120000000,Cotabato (North Cotabato),PH124700000,Pikit,PH124712000,35507,6471,10076,130,530,17431,596,4,74,21,35333,174,0.512891631,18122
Region XII (SOCCSKSARGEN),PH120000000,Cotabato (North Cotabato),PH124700000,President Roxas,PH124713000,10870,3664,5614,5,12,1513,1,1,6,5,10821,49,0.140929674,1525
Region XII (SOCCSKSARGEN),PH120000000,Cotabato (North Cotabato),PH124700000,Tulunan,PH124714000,13500,4862,5558,0,42,2817,3,3,8,64,13357,143,0.216515685,2892
Region XII (SOCCSKSARGEN),PH120000000,Sarangani,PH128000000,Alabel (Capital),PH128001000,17830,6134,5312,10,223,5982,6,0,7,8,17682,148,0.339497794,6003
Region XII (SOCCSKSARGEN),PH120000000,Sarangani,PH128000000,Glan,PH128002000,27955,5500,9739,3,191,12308,4,2,8,10,27765,190,0.444084279,12330
Region XII (SOCCSKSARGEN),PH120000000,Sarangani,PH128000000,Kiamba,PH128003000,13576,4933,3789,32,112,4543,13,2,6,7,13437,139,0.340031257,4569
Region XII (SOCCSKSARGEN),PH120000000,Sarangani,PH128000000,Maasim,PH128004000,13163,4211,3811,2,180,4836,2,0,6,7,13055,108,0.371581769,4851
Region XII (SOCCSKSARGEN),PH120000000,Sarangani,PH128000000,Maitum,PH128005000,10397,3503,2875,2,81,3858,2,0,2,1,10324,73,0.374176676,3863
Region XII (SOCCSKSARGEN),PH120000000,Sarangani,PH128000000,Malapatan,PH128006000,15831,3517,4965,16,35,7092,18,1,3,6,15653,178,0.454800997,7119
Region XII (SOCCSKSARGEN),PH120000000,Sarangani,PH128000000,Malungon,PH128007000,24508,5859,11070,7,81,7255,3,0,9,2,24286,222,0.299308243,7269
Region XII (SOCCSKSARGEN),PH120000000,South Cotabato,PH126300000,Banga,PH126302000,20803,11134,6587,9,89,2885,0,1,3,0,20708,95,0.139463009,2888
Region XII (SOCCSKSARGEN),PH120000000,South Cotabato,PH126300000,City of Koronadal (Capital),PH126306000,42473,26776,11556,23,199,3626,7,3,18,10,42218,255,0.086716566,3661
Region XII (SOCCSKSARGEN),PH120000000,South Cotabato,PH126300000,City of General Santos (Dadiangas),PH126303000,143168,92522,37368,252,474,9922,86,9,141,174,140948,2220,0.073239776,10323
Region XII (SOCCSKSARGEN),PH120000000,South Cotabato,PH126300000,Lake Sebu,PH126319000,18513,2094,11313,15,41,4973,3,0,8,15,18462,51,0.270772397,4999
Region XII (SOCCSKSARGEN),PH120000000,South Cotabato,PH126300000,Norala,PH126311000,10547,5730,3676,5,14,1022,0,2,13,6,10468,79,0.09944593,1041
Region XII (SOCCSKSARGEN),PH120000000,South Cotabato,PH126300000,Polomolok,PH126312000,36485,25114,9316,41,70,1486,16,7,38,28,36116,369,0.043415661,1568
Region XII (SOCCSKSARGEN),PH120000000,South Cotabato,PH126300000,Santo Niño,PH126318000,9594,5593,3180,9,15,620,7,1,5,11,9441,153,0.068107192,643
Region XII (SOCCSKSARGEN),PH120000000,South Cotabato,PH126300000,Surallah,PH126313000,20147,10238,7461,7,40,2292,1,0,10,3,20052,95,0.115000997,2306
Region XII (SOCCSKSARGEN),PH120000000,South Cotabato,PH126300000,Tampakan,PH126314000,9391,4013,4198,49,29,874,4,0,4,4,9175,216,0.096566757,886
Region XII (SOCCSKSARGEN),PH120000000,South Cotabato,PH126300000,Tantangan,PH126315000,10374,4779,3132,3,40,2353,0,0,3,0,10310,64,0.228516004,2356
Region XII (SOCCSKSARGEN),PH120000000,South Cotabato,PH126300000,T'Boli,PH126316000,21289,4769,10473,25,89,5754,8,1,13,23,21155,134,0.274072323,5798
Region XII (SOCCSKSARGEN),PH120000000,South Cotabato,PH126300000,Tupi,PH126317000,16548,7776,5939,10,86,2561,3,0,4,5,16384,164,0.157043457,2573
Region XII (SOCCSKSARGEN),PH120000000,Sultan Kudarat,PH126500000,Bagumbayan,PH126501000,15385,4913,7357,3,70,2962,0,0,3,3,15311,74,0.193847561,2968
Region XII (SOCCSKSARGEN),PH120000000,Sultan Kudarat,PH126500000,City of Tacurong,PH126511000,21588,14529,5395,11,44,1330,0,1,6,2,21318,270,0.062763862,1338
Region XII (SOCCSKSARGEN),PH120000000,Sultan Kudarat,PH126500000,Columbio,PH126502000,8111,1760,1559,5,48,4707,8,2,1,6,8096,15,0.583250988,4722
Region XII (SOCCSKSARGEN),PH120000000,Sultan Kudarat,PH126500000,Esperanza,PH126503000,15756,6830,4608,9,71,3986,6,0,3,5,15518,238,0.257765176,4000
Region XII (SOCCSKSARGEN),PH120000000,Sultan Kudarat,PH126500000,Isulan (Capital),PH126504000,20220,12287,5421,30,123,2102,4,2,4,9,19982,238,0.106045441,2119
Region XII (SOCCSKSARGEN),PH120000000,Sultan Kudarat,PH126500000,Kalamansig,PH126505000,10664,1493,5249,9,23,3803,18,0,6,3,10604,60,0.361184459,3830
Region XII (SOCCSKSARGEN),PH120000000,Sultan Kudarat,PH126500000,Lambayong (Mariano Marcos),PH126508000,17511,7867,4475,23,114,4858,38,2,56,5,17438,73,0.28426425,4957
Region XII (SOCCSKSARGEN),PH120000000,Sultan Kudarat,PH126500000,Lebak,PH126506000,20319,4832,8259,7,97,6966,4,1,11,1,20178,141,0.346020418,6982
Region XII (SOCCSKSARGEN),PH120000000,Sultan Kudarat,PH126500000,Lutayan,PH126507000,13041,3380,2885,0,305,6424,2,0,2,1,12999,42,0.494576506,6429
Region XII (SOCCSKSARGEN),PH120000000,Sultan Kudarat,PH126500000,Palimbang,PH126509000,18993,2359,3842,3,153,12565,9,0,7,8,18946,47,0.664467434,12589
Region XII (SOCCSKSARGEN),PH120000000,Sultan Kudarat,PH126500000,President Quirino,PH126510000,9663,5641,2524,4,28,1383,0,0,7,2,9589,74,0.145166336,1392
Region XII (SOCCSKSARGEN),PH120000000,Sultan Kudarat,PH126500000,Sen. Ninoy Aquino,PH126512000,11669,1284,6425,1,17,3830,4,0,5,39,11605,64,0.334166308,3878
Region XIII (Caraga),PH160000000,Agusan Del Norte,PH160200000,Buenavista,PH160201000,13670,4538,4378,19,260,4271,40,3,10,14,13533,137,0.320328087,4335
Region XIII (Caraga),PH160000000,Agusan Del Norte,PH160200000,City of Butuan (Capital),PH160202000,74972,29785,30588,144,302,13303,91,65,301,152,74731,241,0.185291245,13847
Region XIII (Caraga),PH160000000,Agusan Del Norte,PH160200000,Carmen,PH160204000,4628,1190,1902,1,27,1499,1,0,2,0,4622,6,0.324967547,1502
Region XIII (Caraga),PH160000000,Agusan Del Norte,PH160200000,City of Cabadbaran,PH160203000,16447,7990,3100,4,650,4665,11,1,0,3,16424,23,0.284887969,4679
Region XIII (Caraga),PH160000000,Agusan Del Norte,PH160200000,Jabonga,PH160205000,5114,1224,1364,8,163,2325,28,0,0,2,5114,0,0.460500587,2355
Region XIII (Caraga),PH160000000,Agusan Del Norte,PH160200000,Kitcharao,PH160206000,4022,1625,974,3,37,1377,3,0,0,1,4020,2,0.343532338,1381
Region XIII (Caraga),PH160000000,Agusan Del Norte,PH160200000,Las Nieves,PH160207000,5648,1246,2454,2,43,1897,0,0,2,2,5646,2,0.336698548,1901
Region XIII (Caraga),PH160000000,Agusan Del Norte,PH160200000,Magallanes,PH160208000,4460,1660,1205,1,123,1454,6,0,3,1,4453,7,0.328767123,1464
Region XIII (Caraga),PH160000000,Agusan Del Norte,PH160200000,Nasipit,PH160209000,9079,3449,3936,19,46,1534,36,0,10,12,9042,37,0.176067242,1592
Region XIII (Caraga),PH160000000,Agusan Del Norte,PH160200000,Remedios T. Romualdez,PH160212000,3486,1321,726,2,75,1351,4,0,6,1,3486,0,0.39070568,1362
Region XIII (Caraga),PH160000000,Agusan Del Norte,PH160200000,Santiago,PH160210000,4491,1547,1163,10,106,1613,24,5,17,1,4486,5,0.368925546,1655
Region XIII (Caraga),PH160000000,Agusan Del Norte,PH160200000,Tubay,PH160211000,5180,1897,1061,3,272,1900,4,0,0,1,5138,42,0.370766835,1905
Region XIII (Caraga),PH160000000,Agusan Del Sur,PH160300000,Bunawan,PH160302000,10160,1810,5526,108,19,2480,34,2,39,11,10029,131,0.25565859,2564
Region XIII (Caraga),PH160000000,Agusan Del Sur,PH160300000,City of Bayugan,PH160301000,22438,6473,12132,12,54,3693,7,0,11,3,22385,53,0.165914675,3714
Region XIII (Caraga),PH160000000,Agusan Del Sur,PH160300000,Esperanza,PH160303000,11459,1504,3685,3,70,6186,1,0,3,1,11453,6,0.540557059,6191
Region XIII (Caraga),PH160000000,Agusan Del Sur,PH160300000,La Paz,PH160304000,5246,380,1003,1,34,3780,16,1,12,7,5234,12,0.72888804,3815
Region XIII (Caraga),PH160000000,Agusan Del Sur,PH160300000,Loreto,PH160305000,8947,1270,3062,4,70,4529,4,0,3,1,8943,4,0.507324164,4537
Region XIII (Caraga),PH160000000,Agusan Del Sur,PH160300000,Prosperidad (Capital),PH160306000,18290,4058,7194,61,127,6630,41,3,28,16,18158,132,0.36980945,6715
Region XIII (Caraga),PH160000000,Agusan Del Sur,PH160300000,Rosario,PH160307000,10068,2897,4504,14,40,2336,11,1,5,6,9814,254,0.240269003,2358
Region XIII (Caraga),PH160000000,Agusan Del Sur,PH160300000,San Francisco,PH160308000,16902,6631,6502,43,79,3275,18,5,19,27,16599,303,0.201156696,3339
Region XIII (Caraga),PH160000000,Agusan Del Sur,PH160300000,San Luis,PH160309000,6633,544,1851,2,68,4064,14,0,5,5,6553,80,0.623836411,4088
Region XIII (Caraga),PH160000000,Agusan Del Sur,PH160300000,Santa Josefa,PH160310000,5853,2307,2968,32,11,497,1,1,3,0,5820,33,0.086082474,501
Region XIII (Caraga),PH160000000,Agusan Del Sur,PH160300000,Sibagat,PH160314000,6632,1233,4058,2,14,1246,8,0,3,3,6567,65,0.191868433,1260
Region XIII (Caraga),PH160000000,Agusan Del Sur,PH160300000,Talacogon,PH160311000,8180,1120,2815,8,43,4077,90,0,12,4,8169,11,0.512057779,4183
Region XIII (Caraga),PH160000000,Agusan Del Sur,PH160300000,Trento,PH160312000,11783,3715,5706,8,38,2204,6,2,11,0,11690,93,0.189991446,2221
Region XIII (Caraga),PH160000000,Agusan Del Sur,PH160300000,Veruela,PH160313000,9343,1722,6331,13,27,1168,11,0,14,3,9289,54,0.128754441,1196
Region XIII (Caraga),PH160000000,Dinagat Islands,PH168500000,Basilisa (Rizal),PH168501000,8189,2786,3920,14,27,1359,39,1,4,10,8160,29,0.173039216,1412
Region XIII (Caraga),PH160000000,Dinagat Islands,PH168500000,Cagdianao,PH168502000,3729,1619,910,35,46,1023,21,3,25,46,3728,1,0.299087983,1115
Region XIII (Caraga),PH160000000,Dinagat Islands,PH168500000,Dinagat,PH168503000,2172,1000,557,7,40,535,17,2,3,2,2163,9,0.257512714,557
Region XIII (Caraga),PH160000000,Dinagat Islands,PH168500000,Libjo (Albor),PH168504000,4057,1508,1870,1,19,653,0,0,1,0,4052,5,0.161401777,654
Region XIII (Caraga),PH160000000,Dinagat Islands,PH168500000,Loreto,PH168505000,2228,1039,695,3,39,443,8,0,1,0,2228,0,0.202872531,452
Region XIII (Caraga),PH160000000,Dinagat Islands,PH168500000,San Jose (Capital),PH168506000,5688,2956,1955,17,42,622,20,2,16,15,5645,43,0.119220549,673
Region XIII (Caraga),PH160000000,Dinagat Islands,PH168500000,Tubajon,PH168507000,1839,712,660,0,22,441,2,0,0,0,1837,2,0.241154056,443
Region XIII (Caraga),PH160000000,Surigao Del Norte,PH166700000,Alegria,PH166701000,3402,1614,637,2,54,1092,3,0,0,0,3402,0,0.321869489,1095
Region XIII (Caraga),PH160000000,Surigao Del Norte,PH166700000,Bacuag,PH166702000,2971,1397,436,0,140,997,1,0,0,0,2971,0,0.335913834,998
Region XIII (Caraga),PH160000000,Surigao Del Norte,PH166700000,Burgos,PH166704000,910,432,97,0,47,334,0,0,0,0,910,0,0.367032967,334
Region XIII (Caraga),PH160000000,Surigao Del Norte,PH166700000,Claver,PH166706000,7201,3027,1345,14,274,2484,28,0,1,1,7174,27,0.350432116,2514
Region XIII (Caraga),PH160000000,Surigao Del Norte,PH166700000,Dapa,PH166707000,5129,1992,1331,1,102,1688,2,0,3,0,5119,10,0.330728658,1693
Region XIII (Caraga),PH160000000,Surigao Del Norte,PH166700000,Del Carmen,PH166708000,3892,1328,593,0,155,1704,13,13,59,2,3867,25,0.459787949,1778
Region XIII (Caraga),PH160000000,Surigao Del Norte,PH166700000,General Luna,PH166710000,3837,1686,758,3,70,1303,3,0,0,0,3823,14,0.341616532,1306
Region XIII (Caraga),PH160000000,Surigao Del Norte,PH166700000,Gigaquit,PH166711000,4449,1404,925,0,141,1964,10,0,2,1,4447,2,0.444569373,1977
Region XIII (Caraga),PH160000000,Surigao Del Norte,PH166700000,Mainit,PH166714000,5946,3344,1156,10,105,1282,6,1,8,3,5915,31,0.219611158,1299
Region XIII (Caraga),PH160000000,Surigao Del Norte,PH166700000,Malimono,PH166715000,3992,2143,468,0,217,1157,0,0,1,0,3986,6,0.290516809,1158
Region XIII (Caraga),PH160000000,Surigao Del Norte,PH166700000,Pilar,PH166716000,2353,633,663,1,40,1014,1,0,0,0,2352,1,0.431547619,1015
Region XIII (Caraga),PH160000000,Surigao Del Norte,PH166700000,Placer,PH166717000,5854,2956,1221,3,212,1445,3,0,3,0,5843,11,0.248331337,1451
Region XIII (Caraga),PH160000000,Surigao Del Norte,PH166700000,San Benito,PH166718000,1184,330,381,0,17,454,1,0,0,0,1183,1,0.384615385,455
Region XIII (Caraga),PH160000000,Surigao Del Norte,PH166700000,San Francisco (Anao-Aon),PH166719000,3160,2043,244,2,188,661,6,0,0,0,3144,16,0.212150127,667
Region XIII (Caraga),PH160000000,Surigao Del Norte,PH166700000,San Isidro,PH166720000,1574,589,361,0,21,594,2,0,4,0,1571,3,0.381922342,600
Region XIII (Caraga),PH160000000,Surigao Del Norte,PH166700000,Santa Monica (Sapao),PH166721000,1974,847,455,0,42,630,0,0,0,0,1974,0,0.319148936,630
Region XIII (Caraga),PH160000000,Surigao Del Norte,PH166700000,Sison,PH166722000,2899,1774,603,32,34,422,9,2,4,16,2896,3,0.155732044,451
Region XIII (Caraga),PH160000000,Surigao Del Norte,PH166700000,Socorro,PH166723000,4409,2464,1202,0,116,627,0,0,0,0,4409,0,0.142209118,627
Region XIII (Caraga),PH160000000,Surigao Del Norte,PH166700000,City of Surigao (Capital),PH166724000,34572,20107,10025,84,451,3611,99,16,46,46,34485,87,0.110250834,3802
Region XIII (Caraga),PH160000000,Surigao Del Norte,PH166700000,Tagana-An,PH166725000,3733,1667,967,20,73,980,12,3,2,1,3725,8,0.267114094,995
Region XIII (Caraga),PH160000000,Surigao Del Norte,PH166700000,Tubod,PH166727000,3219,2257,447,10,38,373,40,0,3,30,3198,21,0.139462164,446
Region XIII (Caraga),PH160000000,Surigao Del Sur,PH166800000,Barobo,PH166801000,10567,3125,5707,12,25,1664,1,1,0,1,10536,31,0.158124525,1666
Region XIII (Caraga),PH160000000,Surigao Del Sur,PH166800000,Bayabas,PH166802000,1710,453,218,0,75,964,0,0,0,0,1710,0,0.56374269,964
Region XIII (Caraga),PH160000000,Surigao Del Sur,PH166800000,Cagwait,PH166804000,4319,1003,1680,0,34,1598,2,0,0,2,4319,0,0.370919194,1602
Region XIII (Caraga),PH160000000,Surigao Del Sur,PH166800000,Cantilan,PH166805000,6960,2525,716,0,614,3096,9,0,0,0,6960,0,0.44612069,3105
Region XIII (Caraga),PH160000000,Surigao Del Sur,PH166800000,Carmen,PH166806000,2314,887,319,0,201,906,0,0,0,0,2313,1,0.391699092,906
Region XIII (Caraga),PH160000000,Surigao Del Sur,PH166800000,Carrascal,PH166807000,5003,1517,746,0,162,2576,0,0,0,0,5001,2,0.515096981,2576
Region XIII (Caraga),PH160000000,Surigao Del Sur,PH166800000,City of Bislig,PH166803000,20952,5870,8280,21,115,6475,80,7,45,38,20931,21,0.317137261,6638
Region XIII (Caraga),PH160000000,Surigao Del Sur,PH166800000,City of Tandag (Capital),PH166819000,12014,3838,3753,11,190,4181,1,0,4,18,11996,18,0.35045015,4204
Region XIII (Caraga),PH160000000,Surigao Del Sur,PH166800000,Cortes,PH166808000,3520,1238,772,0,92,1415,1,1,0,0,3519,1,0.402387042,1416
Region XIII (Caraga),PH160000000,Surigao Del Sur,PH166800000,Hinatuan,PH166809000,8750,1381,1854,2,82,5412,16,0,3,0,8750,0,0.620685714,5431
Region XIII (Caraga),PH160000000,Surigao Del Sur,PH166800000,Lanuza,PH166810000,2721,769,293,0,209,1449,0,0,0,1,2721,0,0.532892319,1450
Region XIII (Caraga),PH160000000,Surigao Del Sur,PH166800000,Lianga,PH166811000,6208,1075,3647,3,30,1429,5,2,2,1,6194,14,0.231998708,1437
Region XIII (Caraga),PH160000000,Surigao Del Sur,PH166800000,Lingig,PH166812000,6965,899,1955,11,106,3926,17,0,49,2,6965,0,0.573438622,3994
Region XIII (Caraga),PH160000000,Surigao Del Sur,PH166800000,Madrid,PH166813000,3495,1787,424,0,328,956,0,0,0,0,3495,0,0.273533619,956
Region XIII (Caraga),PH160000000,Surigao Del Sur,PH166800000,Marihatag,PH166814000,3668,1054,1005,0,62,1545,0,0,0,1,3667,1,0.421598037,1546
Region XIII (Caraga),PH160000000,Surigao Del Sur,PH166800000,San Agustin,PH166815000,4548,1328,1308,1,62,1840,4,1,1,3,4548,0,0.406332454,1848
Region XIII (Caraga),PH160000000,Surigao Del Sur,PH166800000,San Miguel,PH166816000,7918,952,3753,0,8,3205,0,0,0,0,7918,0,0.404773933,3205
Region XIII (Caraga),PH160000000,Surigao Del Sur,PH166800000,Tagbina,PH166817000,8318,2082,3349,6,44,2790,3,0,6,1,8281,37,0.338123415,2800
Region XIII (Caraga),PH160000000,Surigao Del Sur,PH166800000,Tago,PH166818000,7852,1325,1990,0,142,4394,0,1,0,0,7852,0,0.559602649,4394
